哎	āi	γεια
唉	āi	ωχ
爱护	ài hù	διατηρώ
爱惜	ài xī	διατηρώ
爱心	ài xīn	αγάπη
安慰	ān wèi	άνεση
安装	ān zhuāng	εγκατάσταση
岸	àn	ακτή
暗	àn	σκοτάδι
熬夜	áo yè	μείνε αργά
把握	bǎ wò	πιάσιμο
摆	bǎi	βάζω
办理	bàn lǐ	λαβή
傍晚	bàng wǎn	απόγευμα
包裹	bāo guǒ	πακέτο
包含	bāo hán	περιέχω
包括	bāo kuò	περιλαμβάνω
薄	báo	λεπτός
保持	bǎo chí	διατηρούν
保存	bǎo cún	αποθηκεύσετε
保留	bǎo liú	διατήρηση
保险	bǎo xiǎn	ασφαλιση
宝贝	bǎo bèi	μωρό
宝贵	bǎo guì	πολύτιμος
报到	bào dào	παραδίδω αποσκευές
报道	bào dào	κανω αναφορα
报告	bào gào	κανω αναφορα
报社	bào shè	εφημερίδα
抱怨	bào yuàn	κανω παραπονα
悲观	bēi guān	δυσοίωνος
背	bèi	πίσω
背景	bèi jǐng	ιστορικό
被子	bèi zi	πάπλωμα
本科	běn kē	φοιτητής
本领	běn lǐng	ικανότητα
本质	běn zhì	φύση
彼此	bǐ cǐ	ο ένας τον άλλον
比例	bǐ lì	ποσοστό
必然	bì rán	αναπόφευκτος
必要	bì yào	απαραίτητη
毕竟	bì jìng	παρά όλα αυτά
避免	bì miǎn	αποφύγει
编辑	biān jí	επεξεργασία
鞭炮	biān pào	κροτίδα
便	biàn	πρύμνη
辩论	biàn lùn	δημόσια συζήτηση
标点	biāo diǎn	σημεία στίξης
标志	biāo zhì	σημάδι
表达	biǎo dá	έκφραση
表面	biǎo miàn	επιφάνεια
表明	biǎo míng	προβολή
表情	biǎo qíng	έκφραση
表现	biǎo xiàn	που έπαιξε
冰激凌	bīng jī líng	παγωτό
病毒	bìng dú	ιός
播放	bō fàng	παίζω
玻璃	bō li	ποτήρι
博物馆	bó wù guǎn	μουσείο
脖子	bó zi	λαιμός
不断	bú duàn	συνέχισε
不见得	bú jiàn de	όχι απαραίτητα
不耐烦	bú nài fán	ανυπόμονος
不要紧	bú yào jǐn	δεν πειράζει
补充	bǔ chōng	συμπλήρωμα
不安	bù ān	ενοχλημένος
不得了	bù dé liǎo	τρομερός
不然	bù rán	σε διαφορετική περίπτωση
不如	bù rú	όχι τόσο καλό όσο
不足	bù zú	ανεπαρκής
布	bù	πανί
步骤	bù zhòu	βήμα
部门	bù mén	τμήμα
财产	cái chǎn	ιδιοκτησία
彩虹	cǎi hóng	ουρανιο τοξο
踩	cǎi	ανέβα
采访	cǎi fǎng	συνέντευξη
采取	cǎi qǔ	παίρνω
参考	cān kǎo	αναφορά
参与	cān yù	συμμετέχω
惭愧	cán kuì	ντροπιασμένος
操场	cāo chǎng	παιδική χαρά
操心	cāo xīn	ανησυχία
册	cè	βιβλίο
测验	cè yàn	δοκιμή
曾经	céng jīng	μια φορά
叉子	chā zi	πιρούνι
差距	chā jù	χάσμα
插	chā	εισάγετε
拆	chāi	απογυμνώ
产品	chǎn pǐn	προϊόν
产生	chǎn shēng	παράγω
常识	cháng shí	κοινη λογικη
长途	cháng tú	μεγάλων αποστάσεων
抄	chāo	αντίγραφο
超级	chāo jí	σούπερ
朝	cháo	προς
潮湿	cháo shī	βρεγμένος
吵	chǎo	θορυβώδης
吵架	chǎo jià	φιλονικία
炒	chǎo	μαρίδα
车库	chē kù	γκαράζ
车厢	chē xiāng	αυτοκίνητο
彻底	chè dǐ	πλήρης
沉默	chén mò	σιωπή
趁	chèn	εκμεταλλεύομαι
称	chēng	ζυγίζω
称呼	chēng hu	κλήση
称赞	chēng zàn	έπαινος
成分	chéng fèn	συστατικό
成果	chéng guǒ	αποτελέσματα
成就	chéng jiù	κατόρθωμα
成立	chéng lì	καθιερωμένος
成人	chéng rén	ενήλικας
成熟	chéng shú	ώριμος
成语	chéng yǔ	ιδίωμα
成长	chéng zhǎng	μεγαλώνοντας
承担	chéng dān	αρκούδα
承认	chéng rèn	αναγνώριση
承受	chéng shòu	αρκούδα
程度	chéng dù	βαθμός
程序	chéng xù	πρόγραμμα
诚恳	chéng kěn	ειλικρινής
吃亏	chī kuī	υποφέρω
持续	chí xù	συνεχίζεται
池塘	chí táng	λιμνούλα
迟早	chí zǎo	αργά ή γρήγορα
尺子	chǐ zi	κυβερνήτης
翅膀	chì bǎng	πτέρυγα
充电器	chōng diàn qì	φορτιστής
充分	chōng fèn	γεμάτος
充满	chōng mǎn	γεμάτος
冲	chōng	βιασύνη
重复	chóng fù	επαναλαμβάνω
宠物	chǒng wù	κατοικίδιο ζώο
抽屉	chōu ti	συρτάρι
抽象	chōu xiàng	αφηρημένη
丑	chǒu	άσχημος
臭	chòu	δύσοσμος
出版	chū bǎn	δημοσίευση
出口	chū kǒu	εξαγωγή
出色	chū sè	εξαιρετική
出示	chū shì	προβολή
出席	chū xí	παραβρίσκομαι
初级	chū jí	πρωταρχικός
除非	chú fēi	εκτός
除夕	chú xī	παραμονή πρωτοχρονιάς
处理	chǔ lǐ	ασχολούμαι με
传播	chuán bō	εξάπλωση
传染	chuán rǎn	μόλυνση
传说	chuán shuō	θρύλος
传统	chuán tǒng	παραδοσιακός
窗帘	chuāng lián	κουρτίνα
闯	chuǎng	βιασύνη
创造	chuàng zào	δημιουργώ
吹	chuī	πλήγμα
词汇	cí huì	λεξιλόγιο
辞职	cí zhí	παραίτηση
此外	cǐ wài	επιπλέον
刺激	cì jī	τόνωση
次要	cì yào	δευτερεύων
匆忙	cōng máng	βιασύνη
从此	cóng cǐ	από τότε
从而	cóng ér	εκ τούτου
从前	cóng qián	πριν
从事	cóng shì	συμμετέχετε
粗糙	cū cāo	τραχύς
促进	cù jìn	προάγω
促使	cù shǐ	προτροπή
醋	cù	ξύδι
催	cuī	υπενθυμίζω
存在	cún zài	υπάρχει
措施	cuò shī	μέτρα
答应	dā ying	υπόσχεση
达到	dá dào	φέρνω σε πέρας
打工	dǎ gōng	μερική απασχόληση
打交道	dǎ jiāo dào	ασχολούμαι με
打喷嚏	dǎ pēn tì	φτάρνισμα
打听	dǎ ting	ρωτήστε για
大方	dà fāng	γενναιόδωρος
大厦	dà shà	κτίριο
大象	dà xiàng	ελέφαντας
大型	dà xíng	μεγάλο
呆	dāi	διαμονή
代表	dài biǎo	εκπρόσωπος
代替	dài tì	αντι αυτου
待遇	dài yù	θεραπευτική αγωγή
贷款	dài kuǎn	δάνειο
单纯	dān chún	απλός
单调	dān diào	μονότονος
单独	dān dú	μόνος
单位	dān wèi	μονάδα
单元	dān yuán	μονάδα
担任	dān rèn	χρησιμεύει ως
耽误	dān wu	καθυστερώ
胆小鬼	dǎn xiǎo guǐ	δειλός
淡	dàn	φως
当地	dāng dì	τοπικός
当心	dāng xīn	προσοχή
挡	dǎng	οικοδομικο τετραγωνο
倒霉	dǎo méi	ατυχος
导演	dǎo yǎn	διευθυντής
导致	dǎo zhì	έχοντας ως αποτέλεσμα
岛屿	dǎo yǔ	νησιά
到达	dào dá	αφίξεις
道德	dào dé	ηθικός
道理	dào lǐ	λόγος
登记	dēng jì	κανω εγγραφη
等待	děng dài	περίμενε
等于	děng yú	ίσος
滴	dī	πτώση
敌人	dí rén	εχθρός
的确	dí què	πράγματι
地道	dì dao	τυπικός
地理	dì lǐ	γεωγραφία
地区	dì qū	περιοχή
地毯	dì tǎn	χαλί
地位	dì wèi	κατάσταση
地震	dì zhèn	σεισμός
递	dì	πέρασμα
点心	diǎn xin	επιδόρπιο
电池	diàn chí	μπαταρία
电台	diàn tái	ραδιοφωνικός σταθμός
钓	diào	αλιεία
顶	dǐng	μπλουζα
冻	dòng	πάγωμα
动画片	dòng huà piān	κινουμενο σχεδιο
洞	dòng	τρύπα
豆腐	dòu fu	τόφου
逗	dòu	πειράζω
独立	dú lì	ανεξάρτητος
独特	dú tè	μοναδικός
度过	dù guò	περάσουν
断	duàn	διακοπή
堆	duī	σωρός
兑换	duì huàn	ανταλλαγή
对比	duì bǐ	σε συγκριση
对待	duì dài	θεραπεύω
对方	duì fāng	άλλη πλευρά
对手	duì shǒu	αντίπαλος
对象	duì xiàng	αντικείμενο
吨	dūn	τόνος
蹲	dūn	κοντόχονδρος
顿	dùn	παύση
多亏	duō kuī	ευχαριστώ
多余	duō yú	περιττός
朵	duǒ	κάνω
躲藏	duǒ cáng	κρύβω
恶劣	è liè	κακό
耳环	ěr huán	σκουλαρίκι
发表	fā biǎo	δημοσιεύω
发愁	fā chóu	ανησυχία
发达	fā dá	αναπτηγμένος
发抖	fā dǒu	τρόμος
发挥	fā huī	παίζω
发明	fā míng	εφεύρεση
发票	fā piào	τιμολόγιο
发言	fā yán	μιλώ
罚款	fá kuǎn	πρόστιμο
法院	fǎ yuàn	δικαστήριο
翻	fān	στροφή
繁荣	fán róng	ευημερία
反而	fǎn ér	αντι αυτου
反复	fǎn fù	κατ 'επανάληψη
反应	fǎn yìng	αντίδραση
反映	fǎn yìng	κατοπτρίζω
反正	fǎn zhèng	τελος παντων
范围	fàn wéi	εύρος
方	fāng	τετράγωνο
方案	fāng àn	πρόγραμμα
方式	fāng shì	ο τροπος
妨碍	fáng ài	εμποδίζω
仿佛	fǎng fú	λες και
非	fēi	μη-
肥皂	féi zào	σαπούνι
废话	fèi huà	ανοησίες
分别	fēn bié	αντίστοιχα
分布	fēn bù	διανέμονται
分配	fēn pèi	κατανομή
分手	fēn shǒu	χωρίζω
分析	fēn xī	ανάλυση
纷纷	fēn fēn	το ένα μετά το άλλο
奋斗	fèn dòu	πάλη
疯狂	fēng kuáng	τρελός
风格	fēng gé	στυλ
风景	fēng jǐng	τοπίο
风俗	fēng sú	έθιμο
风险	fēng xiǎn	κίνδυνος
讽刺	fěng cì	ειρωνεία
否定	fǒu dìng	αρνητικός
否认	fǒu rèn	αρνούμαι
幅	fú	πλάτος
扶	fú	βοήθεια
服装	fú zhuāng	είδη ένδυσης
辅导	fǔ dǎo	προπόνηση
复制	fù zhì	αντίγραφο
妇女	fù nv3	γυναίκες
改革	gǎi gé	μεταρρύθμιση
改进	gǎi jìn	βελτιώσει
改善	gǎi shàn	βελτιώσει
改正	gǎi zhèng	σωστός
概括	gài kuò	γενικεύω
概念	gài niàn	έννοια
盖	gài	κάλυμμα
干脆	gān cuì	απλά
干燥	gān zào	στεγνός
感激	gǎn jī	ευγνώμων
感受	gǎn shòu	αφή
感想	gǎn xiǎng	σκέψεις
赶紧	gǎn jǐn	βιάσου
赶快	gǎn kuài	βιάσου
干活儿	gàn huó r	δουλειά
钢铁	gāng tiě	ατσάλι
高档	gāo dàng	πολυτελή
高级	gāo jí	προχωρημένος
搞	gǎo	συμμετέχετε
告别	gào bié	αποχαιρετήστε
格外	gé wài	ιδιαίτερα
隔壁	gé bì	διπλανή πόρτα
个别	gè bié	άτομο
个人	gè rén	προσωπικός
个性	gè xìng	προσωπικότητα
各自	gè zì	σχετικός
根	gēn	ρίζα
根本	gēn běn	θεμελιώδης
公布	gōng bù	ανακοινώνω
公开	gōng kāi	δημόσιο
公平	gōng píng	έκθεση
公寓	gōng yù	διαμέρισμα
公元	gōng yuán	ενα δ.
公主	gōng zhǔ	πριγκίπισσα
功能	gōng néng	χαρακτηριστικά
工厂	gōng chǎng	εργοστάσιο
工程师	gōng chéng shī	μηχανικός
工具	gōng jù	εργαλείο
工人	gōng rén	εργάτης
工业	gōng yè	βιομηχανία
恭喜	gōng xǐ	συγχαρητήρια
贡献	gòng xiàn	συνεισφορά
沟通	gōu tōng	επικοινωνία
构成	gòu chéng	απαρτίζω
姑姑	gū gu	θεία
姑娘	gū niang	κορίτσι
古代	gǔ dài	αρχαίος
古典	gǔ diǎn	κλασσικός
股票	gǔ piào	στοκ
骨头	gǔ tou	οστό
鼓舞	gǔ wǔ	εμπνέω
鼓掌	gǔ zhǎng	χειροκροτώ
固定	gù dìng	σταθερός
挂号	guà hào	εγγεγραμμένος
乖	guāi	να είσαι καλός
拐弯	guǎi wān	στροφή
怪不得	guài bu de	δεν είναι να απορείς
关闭	guān bì	τερματισμος λειτουργιας
官	guān	επίσημος
观察	guān chá	παρατηρήθηκε
观点	guān diǎn	θέα
观念	guān niàn	ιδέα
管子	guǎn zǐ	σωλήνας
冠军	guàn jūn	πρωταθλητής
光滑	guāng hua	λείος
光临	guāng lín	ελα
光明	guāng míng	λαμπρός
光盘	guāng pán	cd
广场	guǎng chǎng	τετράγωνο
广大	guǎng dà	απέραντος
广泛	guǎng fàn	ευρέως
归纳	guī nà	επαγωγή
规矩	guī ju	κανόνας
规律	guī lv4	νόμος
规模	guī mó	κλίμακα
规则	guī zé	κανόνας
柜台	guì tái	μετρητής
滚	gǔn	ρολό
锅	guō	δοχείο
国庆节	guó qìng jié	εθνική ημέρα
国王	guó wáng	βασιλιάς
果然	guǒ rán	πραγματικά
果实	guǒ shí	καρπός
过分	guò fèn	υπερβολικό
过敏	guò mǐn	αλλεργία
过期	guò qī	έχει λήξει
哈	hā	τι
海关	hǎi guān	ηθη και εθιμα
海鲜	hǎi xiān	θαλασσινά
喊	hǎn	κλήση
行业	háng yè	βιομηχανία
豪华	háo huá	πολυτέλεια
好客	hào kè	φιλόξενος
好奇	hào qí	περίεργος
何必	hé bì	γιατί να ενοχλείς
何况	hé kuàng	για να μην αναφέρουμε
合法	hé fǎ	νόμιμος
合理	hé lǐ	λογικός
合同	hé tong	σύμβαση
合影	hé yǐng	ομαδική φωτογραφία
合作	hé zuò	συνεργασία
和平	hé píng	ειρήνη
核心	hé xīn	πυρήνας
恨	hèn	μισώ
猴子	hóu zi	πίθηκος
后背	hòu bèi	πίσω
后果	hòu guǒ	ως αποτέλεσμα του
呼吸	hū xī	αναπνέω
忽然	hū rán	ξαφνικά
忽视	hū shì	αγνοώ
壶	hú	δοχείο
糊涂	hú tu	ταραγμένος
胡说	hú shuō	ανοησίες
胡同	hú tòng	δρομάκι
蝴蝶	hú dié	πεταλούδα
花生	huā shēng	αράπικο φιστίκι
华裔	huá yì	κινέζικα
滑	huá	γλιστράω
划	huà	σχεδιάζω
化学	huà xué	χημεία
话题	huà tí	θέμα
怀念	huái niàn	δεσποινίδα
怀孕	huái yùn	εγκυμοσύνη
缓解	huǎn jiě	ευκολία
幻想	huàn xiǎng	φαντασία
慌张	huāng zhāng	πανικός
黄金	huáng jīn	χρυσός
恢复	huī fù	επαναφέρω
挥	huī	κύμα
灰	huī	γκρί
灰尘	huī chén	σκόνη
灰心	huī xīn	αποθαρρυνμένος
汇率	huì lv4	συναλλαγματική ισοτιμία
婚礼	hūn lǐ	γάμος
婚姻	hūn yīn	γάμος
活跃	huó yuè	ενεργός
伙伴	huǒ bàn	εταίρος
火柴	huǒ chái	αγώνες
或许	huò xǔ	ίσως
基本	jī běn	βασικός
机器	jī qì	μηχανή
激烈	jī liè	άγριος
肌肉	jī ròu	μυς
及格	jí gé	πέρασμα
急忙	jí máng	βιαστικά
急诊	jí zhěn	επείγον
极其	jí qí	επακρώς
集合	jí hé	σειρά
集体	jí tǐ	συλλογικός
集中	jí zhōng	συμπυκνωμένος
寂寞	jì mò	μοναχικός
系领带	jì lǐng dài	φόρεσε γραβάτα
纪录	jì lù	ρεκόρ
纪律	jì lv4	πειθαρχία
纪念	jì niàn	εορτάζω την μνήμη
计算	jì suàn	υπολογισμός
记录	jì lù	εγγραφή
记忆	jì yì	μνήμη
嘉宾	jiā bīn	επισκέπτης
夹子	jiā zi	συνδετήρας
家庭	jiā tíng	οικογένεια
家务	jiā wù	δουλειες του σπιτιου
家乡	jiā xiāng	ιδιαίτερη πατρίδα
假如	jiǎ rú	αν
假设	jiǎ shè	υπόθεση
假装	jiǎ zhuāng	προσποιούμαι
甲	jiǎ	ενα
价值	jià zhí	αξία
嫁	jià	παντρεύω
驾驶	jià shǐ	οδηγώ
兼职	jiān zhí	μερικής απασχόλησης
坚决	jiān jué	απολύτως
坚强	jiān qiáng	ισχυρός
肩膀	jiān bǎng	ώμος
艰巨	jiān jù	δύσκολος
艰苦	jiān kǔ	σκληρά
剪刀	jiǎn dāo	ψαλίδια
捡	jiǎn	μαζεύω
简历	jiǎn lì	βιογραφικο
简直	jiǎn zhí	απλά
健身	jiàn shēn	καταλληλότητα
建立	jiàn lì	στήνω
建设	jiàn shè	κατασκευή
建筑	jiàn zhù	κτίριο
键盘	jiàn pán	πληκτρολόγιο
讲究	jiǎng jiu	δώσε προσοχή στο
讲座	jiǎng zuò	διάλεξη
酱油	jiàng yóu	σάλτσα σόγιας
交换	jiāo huàn	ανταλλαγή
交际	jiāo jì	επικοινωνία
交往	jiāo wǎng	επικοινωνία
浇	jiāo	χύνω
胶水	jiāo shuǐ	κόλλα
狡猾	jiǎo huá	πονηριά
角度	jiǎo dù	γωνία
教材	jiào cái	βιβλίο
教练	jiào liàn	προπονητής
教训	jiào xun	μάθημα
接触	jiē chù	επικοινωνία
接待	jiē dài	ρεσεψιόν
接近	jiē jìn	κοντά σε
结实	jiē shi	στερεός
阶段	jiē duàn	στάδιο
结构	jié gòu	δομή
结合	jié hé	συνδυασμός
结论	jié lùn	συμπερασματικά
结账	jié zhàng	το λογαριασμό παρακαλώ
节省	jié shěng	αποθηκεύσετε
借口	jiè kǒu	δικαιολογία
届	jiè	συνεδρία
戒	jiè	εγκαταλείπω
戒指	jiè zhi	δαχτυλίδι
金属	jīn shǔ	μέταλλο
尽快	jǐn kuài	αμέσως
紧急	jǐn jí	επείγων
谨慎	jǐn shèn	προσεκτικός
尽力	jìn lì	βάλε τα δυνατά σου
尽量	jìn liàng	προσπάθησε να
近代	jìn dài	μοντέρνοι καιροί
进步	jìn bù	πρόοδος
进口	jìn kǒu	εισαγωγή
精力	jīng lì	ενέργεια
精神	jīng shén	πνεύμα
经典	jīng diǎn	κλασσικός
经商	jīng shāng	κάνοντας δουλειές
经营	jīng yíng	λειτουργικός
酒吧	jiǔ bā	μπαρ
救	jiù	αποθηκεύσετε
救护车	jiù hù chē	ασθενοφόρο
舅舅	jiù jiu	θείος
居然	jū rán	απρόσμενα
桔子	jú zi	πορτοκάλι
俱乐部	jù lè bù	λέσχη
具备	jù bèi	έχω
具体	jù tǐ	ειδικός
巨大	jù dà	τεράστιος
据说	jù shuō	λέγεται ότι
捐	juān	προσφέρω
决赛	jué sài	τελικές εξετάσεις
决心	jué xīn	προσδιορισμός
绝对	jué duì	απόλυτος
角色	jué sè	ρόλοι
军事	jūn shì	στρατός
均匀	jūn yún	εξίσου
卡车	kǎ chē	φορτηγό
开发	kāi fā	ανάπτυξη
开放	kāi fàng	άνοιξε
开幕式	kāi mù shì	τελετή έναρξης
开水	kāi shuǐ	βραστό νερό
砍	kǎn	τομή
看不起	kàn bu qǐ	περιφρονώ
看望	kàn wàng	επίσκεψη
靠	kào	με
颗	kē	κομμάτια
可见	kě jiàn	ορατός
可靠	kě kào	αξιόπιστος
可怕	kě pà	τρομερός
克	kè	γραμμάριο
克服	kè fú	ξεπερνάω
刻苦	kè kǔ	σκληρή δουλειά
客观	kè guān	σκοπός
课程	kè chéng	σειρά μαθημάτων
空间	kōng jiān	χώρος
控制	kòng zhì	έλεγχος
空闲	kòng xián	αδρανής
口味	kǒu wèi	γεύση
夸	kuā	καύχημα
夸张	kuā zhāng	υπερβολή
会计	kuài jì	λογιστική
宽	kuān	πλάτος
昆虫	kūn chóng	έντομο
扩大	kuò dà	επεκτείνουν
辣椒	là jiāo	κοκκινοπίπερο
拦	lán	μπαρ
烂	làn	σάπιος
朗读	lǎng dú	εκφωνούν
劳动	láo dòng	εργασία
劳驾	láo jià	με συγχωρείς
姥姥	lǎo lao	γιαγιά
老百姓	lǎo bǎi xìng	κοινοί άνθρωποι
老板	lǎo bǎn	αφεντικό
老婆	lǎo pó	γυναίκα
老实	lǎo shi	τίμιος
老鼠	lǎo shǔ	ποντίκι
乐观	lè guān	αισιοδοξία
雷	léi	δικος μου
类型	lèi xíng	τύποι
冷淡	lěng dàn	κρύο
厘米	lí mǐ	εκ
梨	lí	αχλάδι
离婚	lí hūn	διαζύγιο
理论	lǐ lùn	θεωρία
理由	lǐ yóu	λόγος
利润	lì rùn	κέρδος
利息	lì xī	ενδιαφέρον
利益	lì yì	ενδιαφέρον
利用	lì yòng	χρήση
力量	lì liang	εξουσία
立即	lì jí	αμέσως
立刻	lì kè	αμέσως
联合	lián hé	άρθρωση
连忙	lián máng	γρήγορα
连续	lián xù	συνεχής
恋爱	liàn ài	ερωτευμένος
粮食	liáng shi	τροφή
良好	liáng hǎo	καλός
亮	liàng	λαμπρός
了不起	liǎo bu qǐ	φοβερο
列车	liè chē	τρένο
临时	lín shí	προσωρινός
灵活	líng huó	εύκαμπτος
铃	líng	κουδούνι
零件	líng jiàn	συστατικά
零食	líng shí	σνακ
领导	lǐng dǎo	ηγετικες ικανοτητες
领域	lǐng yù	πεδίο
流传	liú chuán	εξάπλωση
流泪	liú lèi	δάκρυα
浏览	liú lǎn	ξεφυλλίζω
龙	lóng	δράκων
漏	lòu	διαρροή
录取	lù qǔ	αδεια
录音	lù yīn	εγγραφή
陆地	lù dì	γη
陆续	lù xù	το ένα μετά το άλλο
轮流	lún liú	στροφή
论文	lùn wén	χαρτί
逻辑	luó ji	λογική
落后	luò hòu	πίσω
骂	mà	κατάρα
麦克风	mài kè fēng	μικρόφωνο
馒头	mán tou	ψωμί στον ατμό
满足	mǎn zú	ικανοποιώ
毛病	máo bìng	σφάλμα
矛盾	máo dùn	αντίφαση
冒险	mào xiǎn	περιπέτεια
贸易	mào yì	εμπορία
媒体	méi tǐ	μεσο μαζικης ενημερωσης
煤炭	méi tàn	κάρβουνο
眉毛	méi mao	φρύδι
美术	měi shù	τέχνη
魅力	mèi lì	γοητεία
梦想	mèng xiǎng	όνειρο
密切	mì qiè	κλείσε
秘密	mì mì	μυστικό
秘书	mì shū	γραμματέας
蜜蜂	mì fēng	μέλισσα
面对	miàn duì	πρόσωπο
面积	miàn jī	περιοχή
面临	miàn lín	αντιμέτωπος
描写	miáo xiě	περιγραφή
苗条	miáo tiáo	λεπτός
敏感	mǐn gǎn	ευαίσθητος
名牌	míng pái	διάσημη μάρκα
名片	míng piàn	επαγγελματική κάρτα
名胜古迹	míng shèng gǔ jì	σημεία ενδιαφέροντος
明确	míng què	σαφή
明显	míng xiǎn	φανερός
明星	míng xīng	διασημότητα
命令	mìng lìng	εντολή
命运	mìng yùn	μοίρα
摸	mō	αφή
摩托车	mó tuō chē	μοτοσυκλέτα
模仿	mó fǎng	μιμούμαι
模糊	mó hu	αμαυρός
模特	mó tè	μοντέλο
陌生	mò shēng	παράξενος
某	mǒu	βέβαιος
木头	mù tou	ξύλο
目标	mù biāo	στόχους
目录	mù lù	πίνακας περιεχομένων
目前	mù qián	επί του παρόντος
哪怕	nǎ pà	ακόμα κι αν
难怪	nán guài	δεν είναι να απορείς
难免	nán miǎn	αναπόφευκτος
脑袋	nǎo dài	κεφάλι
内部	nèi bù	εσωτερικός
内科	nèi kē	εσωτερική ιατρική
嫩	nèn	προσφορά
能干	néng gàn	ικανός
能源	néng yuán	ενέργεια
嗯	ńg	εντάξει
年代	nián dài	χρόνια
年纪	nián jì	ηλικία
念	niàn	ανάγνωση
宁可	nìng kě	μάλλον
牛仔裤	niú zǎi kù	τζιν παντελονι
农村	nóng cūn	αγροτική περιοχή
农民	nóng mín	αγρότης
农业	nóng yè	γεωργία
浓	nóng	συμπυκνωμένος
女士	nv3 shì	κυρία
欧洲	ōu zhōu	ευρώπη
偶然	ǒu rán	τυχαίος
拍	pāi	βλαστός
派	pài	στείλετε
盼望	pàn wàng	ελπίδα
培训	péi xùn	εκπαίδευση
培养	péi yǎng	να καλλιεργήσει
赔偿	péi cháng	αποζημίωση
佩服	pèi fú	θαυμάζω
配合	pèi hé	συνεργάζονται
盆	pén	γλάστρες
碰	pèng	χτύπημα
批	pī	σύνολο παραγωγής
批准	pī zhǔn	εγκρίνω
披	pī	phi
疲劳	pí láo	κούραση
匹	pǐ	αγώνας
片	piàn	σεντόνι
片面	piàn miàn	μονόπλευρη
飘	piāo	με τον άνεμο
拼音	pīn yīn	pinyin
频道	pín dào	κανάλι
凭	píng	βασίζομαι σε
平均	píng jūn	μέση τιμή
平	píng	επίπεδο
平安	píng 'ān	ασφαλής
平常	píng cháng	συνήθως
平等	píng děng	ισότητα
平方	píng fāng	τετράγωνο
平衡	píng héng	ισορροπία
平静	píng jìng	ηρεμία
评价	píng jià	εκτίμηση
破产	pò chǎn	πτώχευση
破坏	pò huài	βλάβη
迫切	pò qiè	επείγων
期待	qī dài	ανυπομονώ
期间	qī jiān	περίοδος
其余	qí yú	το υπόλοιπο
奇迹	qí jì	θαύμα
企业	qǐ yè	επιχείρηση
启发	qǐ fā	διαφωτίζω
气氛	qì fēn	ατμόσφαιρα
汽油	qì yóu	βενζίνη
签	qiān	σημάδι
谦虚	qiān xū	μετριόφρων
前途	qián tú	μελλοντικός
浅	qiǎn	ρηχός
欠	qiàn	οφείλω
枪	qiāng	όπλο
墙	qiáng	τείχος
强调	qiáng diào	τονίζω
强烈	qiáng liè	ισχυρός
抢	qiǎng	αρπάζω
悄悄	qiāo qiāo	ήσυχα
瞧	qiáo	κοίτα
巧妙	qiǎo miào	έξυπνος
切	qiē	τομή
亲爱	qīn ài	αγαπητός
亲切	qīn qiè	είδος
亲自	qīn zì	προσωπικά
勤奋	qín fèn	επιμελής
清淡	qīng dàn	φως
轻视	qīng shì	περιφρόνηση
轻易	qīng yì	εύκολα
青	qīng	πράσινος
青春	qīng chūn	νεολαία
青少年	qīng shào nián	έφηβοι
情景	qíng jǐng	σκηνή
情绪	qíng xù	διάθεση
请求	qǐng qiú	αίτηση
庆祝	qìng zhù	γιορτάζω
球迷	qiú mí	ανεμιστήρας
趋势	qū shì	τάση
取消	qǔ xiāo	ματαίωση
娶	qǔ	παντρεύω
去世	qù shì	πέθανε
圈	quān	δαχτυλίδι
全面	quán miàn	περιεκτικός
权利	quán lì	σωστά
权力	quán lì	αυτή η δύναμη
劝	quàn	συμβουλεύω
缺乏	quē fá	έλλειψη
确定	què dìng	καθορίσει
确认	què rèn	επιβεβαιώνω
群	qún	ομάδα
燃烧	rán shāo	καύση
绕	rào	περίπου
热爱	rè ài	αγάπη
热烈	rè liè	ζεστός
热心	rè xīn	ενθουσιώδης
人才	rén cái	ταλέντο
人口	rén kǒu	πληθυσμός
人类	rén lèi	ανθρωπότητα
人民币	rén mín bì	rmb
人生	rén shēng	ζωη
人事	rén shì	προσωπικό
人物	rén wù	χαρακτήρας
人员	rén yuán	προσωπικό
忍不住	rěn bu zhù	δεν μπορώ να βοηθήσω
日常	rì cháng	καθημερινά
日程	rì chéng	πρόγραμμα
日历	rì lì	ημερολόγιο
日期	rì qī	ημερομηνία
日用品	rì yòng pǐn	καθημερινές ανάγκες
日子	rì zi	ημέρα
如何	rú hé	πως είναι
如今	rú jīn	τώρα
软	ruǎn	μαλακός
软件	ruǎn jiàn	λογισμικό
弱	ruò	αδύναμος
洒	sǎ	πασπαλίζω
嗓子	sǎng zi	φωνή
色彩	sè cǎi	χρώμα
杀	shā	σκοτώνω
沙漠	shā mò	έρημος
沙滩	shā tān	παραλία
傻	shǎ	χαζος
晒	shài	προβολή
删除	shān chú	διαγράφω
闪电	shǎn diàn	αστραπή
善良	shàn liáng	καλοσύνη
善于	shàn yú	καλός σε
扇子	shàn zi	ανεμιστήρας
伤害	shāng hài	πλήγμα
商品	shāng pǐn	εμπόρευμα
商务	shāng wù	επιχείρηση
商业	shāng yè	επιχείρηση
上当	shàng dàng	ηλίθιος
蛇	shé	φίδι
舍不得	shě bu de	απρόθυμος
射击	shè jī	κυνήγι
摄影	shè yǐng	φωτογραφία
设备	shè bèi	εξοπλισμός
设计	shè jì	σχέδιο
设施	shè shī	ευκολία
伸	shēn	τέντωμα
深刻	shēn kè	βαθύς
身材	shēn cái	εικόνα
身份	shēn fèn	ταυτότητα
神话	shén huà	μύθος
神秘	shén mì	μυστηριώδης
升	shēng	αύξηση
声调	shēng diào	τόνος
生产	shēng chǎn	παράγω
生动	shēng dòng	ζωηρός
生长	shēng zhǎng	καλλιεργώ
绳子	shéng zi	σκοινί
省略	shěng lüè	παραλείπω
胜利	shèng lì	νίκη
失眠	shī mián	αυπνία
失去	shī qù	χάνω
失业	shī yè	ανεργία
湿润	shī rùn	υγρός
狮子	shī zi	λιοντάρι
诗	shī	ποίηση
实话	shí huà	αλήθεια
实践	shí jiàn	πρακτική
实习	shí xí	πρακτική
实现	shí xiàn	φέρνω σε πέρας
实验	shí yàn	πείραμα
实用	shí yòng	πρακτικός
时差	shí chā	jet lag
时代	shí dài	εποχή
时刻	shí kè	χρόνος
时髦	shí máo	μόδας
时期	shí qī	περίοδος
时尚	shí shàng	μόδα
石头	shí tou	πέτρα
食物	shí wù	τροφή
使劲儿	shǐ jìn r	σκληρά
始终	shǐ zhōng	πάντα
事实	shì shí	γεγονός
事物	shì wù	πράγμα
事先	shì xiān	εκ των προτέρων
似的	shì de	αρέσει
士兵	shì bīng	στρατιώτης
市场	shì chǎng	αγορά
试卷	shì juàn	δοκιμαστικό χαρτί
收获	shōu huò	ανταμοιβή
收据	shōu jù	παραλαβή
手工	shǒu gōng	εγχειρίδιο
手术	shǒu shù	χειρουργική επέμβαση
手套	shǒu tào	γάντια
手续	shǒu xù	διατυπώσεις
手指	shǒu zhǐ	δάχτυλο
首	shǒu	πρώτα
受伤	shòu shāng	τραυματίας
寿命	shòu mìng	ζωη
书架	shū jià	ράφι
梳子	shū zi	χτένα
舒适	shū shì	ανετος
蔬菜	shū cài	λαχανικά
输入	shū rù	εισαγω
熟练	shú liàn	έμπειρος
属于	shǔ yú	ανήκω
数	shǔ	αριθμός
鼠标	shǔ biāo	ποντίκι
数据	shù jù	δεδομένα
数码	shù mǎ	ψηφιακό
摔倒	shuāi dǎo	πτώση
甩	shuǎi	εγκαταλείπω
双方	shuāng fāng	δυο πλευρες
税	shuì	φόρος
说不定	shuō bu dìng	μπορεί
说服	shuō fú	πείθω
丝绸	sī chóu	μετάξι
丝毫	sī háo	παραμικρό
思考	sī kǎo	σκέψη
思想	sī xiǎng	σκέψη
撕	sī	σχίσιμο
私人	sī rén	ιδιωτικός
似乎	sì hū	φαίνομαι
搜索	sōu suǒ	ψάχνω για
宿舍	sù shè	κοιτώνας
随身	suí shēn	μεταφέρω
随时	suí shí	οποιαδήποτε στιγμή
随手	suí shǒu	ανέμελα
碎	suì	σπασμένος
损失	sǔn shī	απώλεια
缩短	suō duǎn	βραχύνω
所	suǒ	έτσι
锁	suǒ	κλειδαριά
台阶	tái jiē	βήματα
太极拳	tài jí quán	tai chi
太太	tài tai	κυρία
谈判	tán pàn	διαπραγμάτευση
坦率	tǎn shuài	ειλικρινής
烫	tàng	ζεστό
桃	táo	ροδάκινο
淘气	táo qì	άτακτος
逃	táo	διαφυγή
逃避	táo bì	διαφυγή
讨价还价	tǎo jià huán jià	παζάρι
套	tào	σειρά
特色	tè sè	χαρακτηριστικά
特殊	tè shū	ειδικός
特征	tè zhēng	χαρακτηριστικό
疼爱	téng ài	αγάπη
提倡	tí chàng	προάγω
提纲	tí gāng	περίγραμμα
提问	tí wèn	κανε ερωτησεις
题目	tí mù	θέμα
体会	tǐ huì	εμπειρία
体贴	tǐ tiē	διακριτικός
体现	tǐ xiàn	κατοπτρίζω
体验	tǐ yàn	εμπειρία
天空	tiān kōng	ουρανός
天真	tiān zhēn	αφελής
调皮	tiáo pí	άτακτος
调整	tiáo zhěng	προσαρμογή
挑战	tiǎo zhàn	πρόκληση
通常	tōng cháng	συνήθως
统一	tǒng yī	ενώνω
痛苦	tòng kǔ	πόνος
痛快	tòng kuài	ευτυχισμένος
偷	tōu	κλέβω
投入	tóu rù	επένδυσε σε
投资	tóu zī	επένδυση
透明	tòu míng	διαφανής
突出	tū chū	διακεκριμένος
土地	tǔ dì	γη
土豆	tǔ dòu	πατάτα
兔子	tù zi	κουνέλι
吐	tù	έκανε εμετό
团	tuán	ομάδα
推辞	tuī cí	πτώση
推广	tuī guǎng	προάγω
推荐	tuī jiàn	συνιστώ
退	tuì	υποχώρηση
退步	tuì bù	οπισθοχώρηση
退休	tuì xiū	συνταξιοδότηση
歪	wāi	ανέντιμος
外公	wài gōng	παππούς
外交	wài jiāo	διπλωματικός
完美	wán měi	τέλειος
完善	wán shàn	τέλειος
完整	wán zhěng	πλήρης
玩具	wán jù	παιχνίδι
万一	wàn yī	για κάθε περίπτωση
王子	wáng zǐ	πρίγκιπας
往返	wǎng fǎn	ταξίδι μετ επιστροφής
网络	wǎng luò	το διαδίκτυο
危害	wēi hài	κανω κακο
威胁	wēi xié	απειλή
微笑	wēi xiào	χαμόγελο
唯一	wéi yī	μόνο
围巾	wéi jīn	κασκόλ
围绕	wéi rào	περίπου
维修	wéi xiū	υπηρεσία
违反	wéi fǎn	παράβαση
伟大	wěi dà	μεγάλος
委屈	wěi qū	λάθος
尾巴	wěi ba	ουρά
位于	wèi yú	χουζουρεύω
位置	wèi zhi	θέση
未必	wèi bì	όχι απαραίτητα
未来	wèi lái	μελλοντικός
胃	wèi	στομάχι
胃口	wèi kǒu	όρεξη
温暖	wēn nuǎn	ζεστός
温柔	wēn róu	προσφορά
文件	wén jiàn	αρχείο
文具	wén jù	γραφική ύλη
文明	wén míng	πολιτισμός
文学	wén xué	βιβλιογραφία
文字	wén zì	κείμενο
闻	wén	μυρωδιά
吻	wěn	φιλί
稳定	wěn dìng	σταθερός
问候	wèn hòu	χαιρετίσματα
卧室	wò shì	υπνοδωμάτιο
握手	wò shǒu	χειραψία
屋子	wū zi	δωμάτιο
无奈	wú nài	ανήμπορος
无数	wú shù	αμέτρητος
无所谓	wú suǒ wèi	δεν πειράζει
武术	wǔ shù	πολεμικές τέχνες
勿	wù	μην
物理	wù lǐ	φυσικός
物质	wù zhì	ουσία
雾	wù	ομίχλη
吸取	xī qǔ	σχεδιάζω
吸收	xī shōu	απορροφώ
戏剧	xì jù	δράμα
系	xì	σύστημα
系统	xì tǒng	σύστημα
细节	xì jié	λεπτομέρεια
瞎	xiā	τυφλός
下载	xià zǎi	κατεβάστε
吓	xià	φόβος
夏令营	xià lìng yíng	κατασκήνωση
鲜艳	xiān yàn	λαμπρός
显得	xiǎn de	εμφανίζομαι
显然	xiǎn rán	προφανώς
显示	xiǎn shì	απεικόνιση
县	xiàn	κομητεία
现代	xiàn dài	μοντέρνο
现实	xiàn shí	πραγματικότητα
现象	xiàn xiàng	φαινόμενο
限制	xiàn zhì	όριο
相处	xiāng chǔ	πηγαίνω καλά
相当	xiāng dāng	αρκετά
相对	xiāng duì	σχετικά
相关	xiāng guān	σχετιζομαι με
相似	xiāng sì	παρόμοιος
香肠	xiāng cháng	λουκάνικο
享受	xiǎng shòu	απολαμβάνω
想念	xiǎng niàn	δεσποινίδα
想象	xiǎng xiàng	φαντάζομαι
象棋	xiàng qí	σκάκι
象征	xiàng zhēng	σύμβολο
项	xiàng	είδος
项链	xiàng liàn	κολιέ
项目	xiàng mù	έργο
消费	xiāo fèi	κατανάλωση
消化	xiāo huà	πέψη
消极	xiāo jí	αρνητικός
消失	xiāo shī	εξαφανίζομαι
销售	xiāo shòu	εκπτώσεις
小麦	xiǎo mài	σιτάρι
小气	xiǎo qi	τσιγκούνης
孝顺	xiào shun	φιλική ευσέβεια
效率	xiào lv4	αποτελεσματικότητα
歇	xiē	υπόλοιπο
斜	xié	λοξός
写作	xiě zuò	γραφή
心理	xīn lǐ	ψυχολογικός
心脏	xīn zàng	καρδιά
欣赏	xīn shǎng	απολαμβάνω
信号	xìn hào	σήμα
信任	xìn rèn	εμπιστοσύνη
形成	xíng chéng	μορφή
形容	xíng róng	περιγράφω
形势	xíng shì	κατάσταση
形式	xíng shì	μορφή
形象	xíng xiàng	εικόνα
形状	xíng zhuàng	σχήμα
行动	xíng dòng	δράση
行人	xíng rén	πεζός
行为	xíng wéi	η συμπεριφορα
幸亏	xìng kuī	ευτυχώς
幸运	xìng yùn	τυχερός
性质	xìng zhì	φύση
兄弟	xiōng dì	αδερφια
胸	xiōng	στήθος
休闲	xiū xián	ανέμελος
修改	xiū gǎi	τροποποιώ
虚心	xū xīn	μετριόφρων
叙述	xù shù	διηγούμαι
宣布	xuān bù	ανακοινώνω
宣传	xuān chuán	δημοσιότητα
学历	xué lì	εκπαίδευση
学术	xué shù	ακαδημαϊκός
学问	xué wèn	η γνώση
血	xuè	αίμα
寻找	xún zhǎo	αναζήτηση
询问	xún wèn	παρακαλώ
训练	xùn liàn	εκπαίδευση
迅速	xùn sù	ταχύς
押金	yā jīn	κατάθεση
牙齿	yá chǐ	δόντι
严肃	yán sù	σοβαρός
延长	yán cháng	επεκτείνω
演讲	yǎn jiǎng	ομιλία
宴会	yàn huì	συμπόσιο
阳台	yáng tái	μπαλκόνι
痒	yǎng	φαγούρα
样式	yàng shì	στυλ
腰	yāo	μέση
摇	yáo	σέικ
咬	yǎo	δάγκωμα
要不	yào bù	ή
业务	yè wù	επιχείρηση
业余	yè yú	ερασιτέχνης
夜	yè	νύχτα
依然	yī rán	ακόμη
一辈子	yí bèi zi	διάρκεια ζωής
一旦	yí dàn	μια φορά
一律	yí lv4	πάντα
一再	yí zài	κατ 'επανάληψη
一致	yí zhì	σταθερός
疑问	yí wèn	αμφιβολία
移动	yí dòng	κινητό
移民	yí mín	μετανάστευση
遗憾	yí hàn	μετανιώνω
乙	yǐ	σι
以及	yǐ jí	καθώς
以来	yǐ lái	από
义务	yì wù	υποχρέωση
亿	yì	δισεκατομμύριο
意外	yì wài	ατύχημα
意义	yì yì	σημασία
议论	yì lùn	μιλα ρε
因而	yīn ér	έτσι
因素	yīn sù	παράγοντας
银	yín	ασήμι
印刷	yìn shuā	τυπώνω
英俊	yīng jùn	όμορφος
英雄	yīng xióng	ήρωας
营养	yíng yǎng	θρέψη
营业	yíng yè	επιχείρηση
迎接	yíng jiē	συναντώ
影子	yǐng zi	σκιά
应付	yìng fu	λαβή
应用	yìng yòng	εφαρμογή
硬	yìng	σκληρά
硬件	yìng jiàn	σκεύη, εξαρτήματα
拥抱	yōng bào	εναγκαλισμός
拥挤	yōng jǐ	γεματο κοσμο
勇气	yǒng qì	θάρρος
用功	yòng gōng	δούλεψε σκληρά
用途	yòng tú	χρήση
优惠	yōu huì	εκπτωση
优美	yōu měi	πανεμορφη
优势	yōu shì	πλεονέκτημα
悠久	yōu jiǔ	μακρύς
油炸	yóu zhá	τηγανητό
游览	yóu lǎn	περιοδεία
犹豫	yóu yù	διστάζω
有利	yǒu lì	ευνοϊκός
幼儿园	yòu ér yuán	νηπιαγωγείο
娱乐	yú lè	ψυχαγωγία
与其	yǔ qí	αντί
语气	yǔ qì	τόνος
玉米	yù mǐ	καλαμπόκι
预报	yù bào	πρόβλεψη
预订	yù dìng	κράτηση
预防	yù fáng	πρόληψη
元旦	yuán dàn	πρωτοχρονιά
原料	yuán liào	πρώτη ύλη
原则	yuán zé	κατ 'αρχήν
员工	yuán gōng	υπάλληλος
圆	yuán	γύρος
愿望	yuàn wàng	επιθυμία
乐器	yuè qì	μουσικό όργανο
晕	yūn	θέε μου
运气	yùn qi	τυχη
运输	yùn shū	μεταφορά
运用	yùn yòng	χρήση
灾害	zāi hài	καταστροφή
再三	zài sān	κατ 'επανάληψη
在乎	zài hu	φροντίδα
在于	zài yú	εγκειται στην
赞成	zàn chéng	συμφωνώ
赞美	zàn měi	έπαινος
糟糕	zāo gāo	κακό
造成	zào chéng	αιτία
则	zé	τότε
责备	zé bèi	κατηγορώ
摘	zhāi	διαλέγω
窄	zhǎi	στενός
粘贴	zhān tiē	επικόλληση
展开	zhǎn kāi	ξεδιπλωθεί
展览	zhǎn lǎn	έκθεση
占	zhàn	καταλαμβάνουν
战争	zhàn zhēng	πόλεμος
掌握	zhǎng wò	πιάσιμο
涨	zhǎng	αύξηση
长辈	zhǎng bèi	μεγαλύτερος
账户	zhàng hù	λογαριασμός
招待	zhāo dài	διασκεδάζω
着火	zháo huǒ	καίγεται
着凉	zháo liáng	πιάσε κρύο
召开	zhào kāi	κρατήστε
照常	zhào cháng	ως συνήθως
哲学	zhé xué	φιλοσοφία
珍惜	zhēn xī	διατηρώ
真实	zhēn shí	πραγματικός
针对	zhēn duì	κατά
诊断	zhěn duàn	διάγνωση
振动	zhèn dòng	δόνηση
阵	zhèn	πίνακας
争论	zhēng lùn	δημόσια συζήτηση
争取	zhēng qǔ	προσπαθούμε για
征求	zhēng qiú	ψάχνω
挣	zhēng	κερδίζω
睁	zhēng	ανοικτά μάτια
整个	zhěng gè	ολόκληρος
整齐	zhěng qí	καθαρός
整体	zhěng tǐ	συνολικά
政府	zhèng fǔ	κυβέρνηση
政治	zhèng zhì	πολιτικός
正	zhèng	θετικός
证件	zhèng jiàn	πιστοποιητικό
证据	zhèng jù	απόδειξη
支	zhī	υποστήριξη
支票	zhī piào	έλεγχος
执照	zhí zhào	άδεια
直	zhí	ευθεία
指导	zhǐ dǎo	οδηγός
指挥	zhǐ huī	εντολή
制定	zhì dìng	φτιαχνω, κανω
制度	zhì dù	σύστημα
制造	zhì zào	κατασκευή
制作	zhì zuò	φτιαχνω, κανω
志愿者	zhì yuàn zhě	εθελοντής
智慧	zhì huì	σοφία
治疗	zhì liáo	θεραπευτική αγωγή
秩序	zhì xù	σειρά
至今	zhì jīn	μέχρι σήμερα
至于	zhì yú	οσον αφορά
中介	zhōng jiè	μεσολαβητής
中心	zhōng xīn	κέντρο
中旬	zhōng xún	μεσοπρόθεσμα
种类	zhǒng lèi	είδος
重大	zhòng dà	μείζων
重量	zhòng liàng	βάρος
周到	zhōu dao	προσεκτικός
猪	zhū	χοίρος
竹子	zhú zi	μπαμπού
逐步	zhú bù	βήμα βήμα
逐渐	zhú jiàn	σταδιακά
主持	zhǔ chí	πλήθος
主动	zhǔ dòng	πρωτοβουλία
主观	zhǔ guān	υποκειμενικός
主人	zhǔ rén	ο οικοδεσπότης
主任	zhǔ rèn	διευθυντής
主题	zhǔ tí	θέμα
主席	zhǔ xí	πρόεδρος
主张	zhǔ zhāng	απαίτηση
煮	zhǔ	μάγειρας
注册	zhù cè	εγγεγραμμένος
祝福	zhù fú	ευλογία
抓	zhuā	αρπάζω
抓紧	zhuā jǐn	δώστε ιδιαίτερη προσοχή
专家	zhuān jiā	εμπειρογνώμονας
专心	zhuān xīn	συγκεντρώνομαι
转变	zhuǎn biàn	αλλαγή
转告	zhuǎn gào	λέγω
装	zhuāng	εγκαθιστώ
装饰	zhuāng shì	διακόσμηση
装修	zhuāng xiū	διακόσμηση
撞	zhuàng	κτύπημα
状况	zhuàng kuàng	κατάσταση
状态	zhuàng tài	κατάσταση
追	zhuī	κυνηγητό
追求	zhuī qiú	επιδιώκω
咨询	zī xún	συμβουλευτικός
姿势	zī shì	σταση του σωματος
资格	zī gé	προσόντα
资金	zī jīn	κεφάλαια
资料	zī liào	δεδομένα
资源	zī yuán	πόροι
紫	zǐ	μωβ
字母	zì mǔ	γράμμα
字幕	zì mù	υπότιτλος
自从	zì cóng	από
自动	zì dòng	αυτόματο
自豪	zì háo	υπερηφάνεια
自觉	zì jué	συνειδητός
自私	zì sī	εγωιστικός
自由	zì yóu	ελεύθερος
自愿	zì yuàn	εθελοντής
综合	zōng hé	περιεκτικός
总裁	zǒng cái	πρόεδρος
总共	zǒng gòng	συνολικά
总理	zǒng lǐ	πρωθυπουργός
总算	zǒng suàn	τελικά
总统	zǒng tǒng	πρόεδρος
总之	zǒng zhī	εν συντομία
组	zǔ	ομάδα
组成	zǔ chéng	σύνθεση
组合	zǔ hé	συνδυασμός
组织	zǔ zhī	οργάνωση
阻止	zǔ zhǐ	αποτρέψει
最初	zuì chū	αρχικός
醉	zuì	μεθυσμένος
尊敬	zūn jìng	σεβασμός
遵守	zūn shǒu	συμμορφώνεται με
作品	zuò pǐn	έργα
作为	zuò wéi	οπως και
作文	zuò wén	σύνθεση
