挨	ái	υποφέρω
癌症	ái zhèng	καρκίνος
暧昧	ài mèi	ασαφής
爱不释手	ài bù shì shǒu	βάλτε το κάτω
爱戴	ài dài	αγάπη
安宁	ān níng	ειρηνικός
安详	ān xiáng	γαλήνιος
安置	ān zhì	τοποθέτηση
按摩	àn mó	μασάζ
暗示	àn shì	ιχνος
案件	àn jiàn	υπόθεση
案例	àn lì	υπόθεση
昂贵	áng guì	ακριβός
凹凸	āo tū	χτύπημα
熬	áo	βρασμός
奥秘	ào mì	μυστήριο
巴不得	bā bù dé	ανήσυχος
巴结	bā jie	ελαφάκι
扒	bā	ψηνω στα καρβουνα
疤	bā	ουλή
拔苗助长	bá miáo zhù zhǎng	αναβάθμιση
把关	bǎ guān	έλεγχος
把手	bǎ shǒu	λαβή
罢工	bà gōng	απεργία
霸道	bà dào	καταθλιπτικός
掰	bāi	αντίο
摆脱	bǎi tuō	ξεφορτώνομαι
拜访	bài fǎng	επίσκεψη
拜年	bài nián	ευτυχισμένο το νέο έτος
拜托	bài tuō	σας παρακαλούμε
败坏	bài huài	διεφθαρμένος
斑	bān	σημείο
颁布	bān bù	διακηρύττω
颁发	bān fā	θέμα
版本	bǎn běn	εκδοχή
伴侣	bàn lv3	σύντροφος
伴随	bàn suí	συνοδευτικά
半途而废	bàn tú ér fèi	σταματήστε στη μέση
扮演	bàn yǎn	παίζω
榜样	bǎng yàng	παράδειγμα
绑架	bǎng jià	απαγωγή
磅	bàng	λίβρα
包庇	bāo bì	καταφύγιο
包袱	bāo fu	βάρος
包围	bāo wéi	περιτριγυρισμένο
包装	bāo zhuāng	πακέτο
保管	bǎo guǎn	επιμέλεια
保密	bǎo mì	κρατώ μυστικό
保姆	bǎo mǔ	νταντά
保守	bǎo shǒu	συντηρητικός
保卫	bǎo wèi	υπερασπίζω
保养	bǎo yǎng	συντήρηση
保障	bǎo zhàng	εγγύηση
保重	bǎo zhòng	να προσέχεις
饱和	bǎo hé	κορεσμός
饱经沧桑	bǎo jīng cāng sāng	βάσεις
报酬	bào chou	αμοιβή
报仇	bào chóu	εκδίκηση
报答	bào dá	ανταποδίδω
报复	bào fù	εκδίκηση
报警	bào jǐng	καλεσε την αστυνομια
报销	bào xiāo	αποζημίωση
抱负	bào fù	φιλοδοξία
暴力	bào lì	βία
暴露	bào lù	εκτεθειμένος
曝光	bào guāng	έκθεση
爆发	bào fā	ξεσπώ
爆炸	bào zhà	έκρηξη
卑鄙	bēi bǐ	σημαίνω
悲哀	bēi āi	λύπη
悲惨	bēi cǎn	τραγικός
北极	běi jí	αρκτικός
备份	bèi fèn	αντιγράφων ασφαλείας
备忘录	bèi wàng lù	υπόμνημα
背叛	bèi pàn	προδίδω
背诵	bèi sòng	διηγούμαι
被动	bèi dòng	παθητικός
被告	bèi gào	εναγόμενος
贝壳	bèi ké	κέλυφος
奔波	bēn bō	τρέχουν γύρω
奔驰	bēn chí	μπενζ
本能	běn néng	ένστικτο
本钱	běn qián	κεφάλαιο
本人	běn rén	εγώ ο ίδιος
本身	běn shēn	εαυτό
本事	běn shi	ικανότητα
笨拙	bèn zhuō	αδέξιος
崩溃	bēng kuì	κατάρρευση
甭	béng	όχι
蹦	bèng	άλμα
迸发	bèng fā	εκρηξη
逼迫	bī pò	δύναμη
鼻涕	bí tì	μύτη
比方	bǐ fang	για παράδειγμα
比喻	bǐ yù	μεταφορική έννοια
比重	bǐ zhòng	ποσοστό
鄙视	bǐ shì	περιφρονώ
弊病	bì bìng	δυσφορία
弊端	bì duān	μειονεκτήματα
臂	bì	μπράτσο
闭塞	bì sè	απορροφώ
编织	biān zhī	υφανση
边疆	biān jiāng	σύνορο
边界	biān jiè	όριο
边境	biān jìng	σύνορο
边缘	biān yuán	άκρη
鞭策	biān cè	ωθηση
扁	biǎn	διαμέρισμα
贬低	biǎn dī	υποτιμώ
贬义	biǎn yì	υποτιμητικός
便利	biàn lì	βολικός
便条	biàn tiáo	σημείωση
便于	biàn yú	ευκολο να
变故	biàn gù	ατυχία
变迁	biàn qiān	αλλαγή
变质	biàn zhì	φθορά
辨认	biàn rèn	αναγνωρίζω
辩护	biàn hù	υπερασπίζω
辩解	biàn jiě	δικαιολογία
辩证	biàn zhèng	διαλεκτικός
辫子	biàn zi	πλέκω
遍布	biàn bù	παντού
标本	biāo běn	δείγμα
标记	biāo jì	σημάδι
标题	biāo tí	τίτλος
表决	biǎo jué	ψήφος
表态	biǎo tài	στάση
表彰	biǎo zhāng	αναγνώριση
憋	biē	κρατώ πίσω
别墅	bié shù	βίλα
别致	bié zhì	σικ
别扭	biè niu	αδέξιος
濒临	bīn lín	στα πρόθυρα της
冰雹	bīng báo	χαλάζι
丙	bǐng	ντο
并非	bìng fēi	δεν
并列	bìng liè	δίπλα δίπλα
剥削	bō xuē	εκμεταλλεύομαι
拨	bō	καντράν
播种	bō zhòng	σπορά
波浪	bō làng	κύμα
波涛	bō tāo	κυματιστά
伯母	bó mǔ	θεία
博大精深	bó dà jīng shēn	ευρεία και βαθιά
博览会	bó lǎn huì	εκθεση
搏斗	bó dòu	πάλη
薄弱	bó ruò	αδύναμος
不顾	bú gù	ασχέτως
不愧	bú kuì	αξίζει να
不料	bú liào	απρόσμενα
不像话	bú xiàng huà	αποτρόπαιος
不屑一顾	bú xiè yī gù	απορρίπτει
哺乳	bǔ rǔ	θηλασμός
捕捉	bǔ zhuō	πιάνω
补偿	bǔ cháng	μακιγιάζ
补救	bǔ jiù	θεραπεία
补贴	bǔ tiē	επιδότηση
不得已	bù dé yǐ	εσχατη λύση
不妨	bù fáng	θα μπορούσε κάλλιστα
不敢当	bù gǎn dāng	μην τολμήσεις
不禁	bù jīn	δεν μπορώ να βοηθήσω
不堪	bù kān	ανυπόφορος
不可思议	bù kě sī yì	απίστευτος
不免	bù miǎn	αναπόφευκτα
不时	bù shí	πότε-πότε
不惜	bù xī	μην διστάσετε
不相上下	bù xiāng shàng xià	συγκρίσιμος
不言而喻	bù yán ér yù	είναι αυτονόητο
不由得	bù yóu de	δεν μπορώ να βοηθήσω, αλλά
不择手段	bù zé shǒu duàn	παιξε σκληρα
不止	bù zhǐ	περισσότερο από
布告	bù gào	ειδοποίηση
布局	bù jú	διάταξη
布置	bù zhì	διάταξη
步伐	bù fá	βήμα
部署	bù shǔ	παρατάσσω
部位	bù wèi	τοποθεσία
才干	cái gàn	επάρκεια
裁缝	cái feng	ράφτης
裁判	cái pàn	διαιτητής
裁员	cái yuán	απολύσεις
财富	cái fù	πλούτος
财务	cái wù	χρηματοδότηση
财政	cái zhèng	χρηματοοικονομική
彩票	cǎi piào	λαχείο
采购	cǎi gòu	αγορά
采集	cǎi jí	συλλογή
采纳	cǎi nà	υιοθεσία
参谋	cān móu	προσωπικό
参照	cān zhào	αναφορά
残疾	cán jí	αναπηρία
残酷	cán kù	σκληρός
残留	cán liú	υπόλειμμα
残忍	cán rěn	σκληρός
灿烂	càn làn	λαμπρός
仓促	cāng cù	βιαστικός
仓库	cāng kù	αποθήκη
舱	cāng	καμπίνα
苍白	cāng bái	χλωμός
操劳	cāo láo	δούλεψε σκληρά
操练	cāo liàn	πρακτική
操纵	cāo zòng	χειραγωγώ
操作	cāo zuò	λειτουργικός
嘈杂	cáo zá	θορυβώδης
草案	cǎo àn	προσχέδιο
草率	cǎo shuài	βιαστικός
侧面	cè miàn	πλευρά
测量	cè liáng	μέτρημα
策划	cè huà	σχέδιο
策略	cè lvè	στρατηγική
层出不穷	céng chū bù qióng	ατελείωτες
层次	céng cì	επίπεδο
差别	chā bié	διαφορά
插座	chā zuò	πρίζα
查获	chá huò	κατασχέθηκε
刹那	chà nà	στιγμή
岔	chà	πιρούνι
诧异	chà yì	εκπληκτος
柴油	chái yóu	ντίζελ
搀	chān	μείγμα
缠绕	chán rào	κούρδισμα
馋	chán	άπληστος
产业	chǎn yè	βιομηχανία
阐述	chǎn shù	επεξεργάζομαι
颤抖	chàn dǒu	τρόμος
昌盛	chāng shèng	ευημερία
偿还	cháng huán	ανταποδίδω
尝试	cháng shì	δοκιμάστε
场合	chǎng hé	ευκαιρία
场面	chǎng miàn	σκηνή
场所	chǎng suǒ	θέση
敞开	chǎng kāi	ορθάνοιχτα
倡导	chàng dǎo	συνήγορος
倡议	chàng yì	πρωτοβουλία
畅通	chàng tōng	ξεκλείδωμα
畅销	chàng xiāo	καλύτερος πωλητής
超越	chāo yuè	πέρα
钞票	chāo piào	τραπεζογραμμάτιο
嘲笑	cháo xiào	πετάω στα δόντια
巢穴	cháo xué	φωλιά
朝代	cháo dài	δυναστεία
潮流	cháo liú	τάση
撤退	chè tuì	υποχώρηση
撤销	chè xiāo	ανακαλώ
沉淀	chén diàn	κατακρήμνιση
沉闷	chén mèn	αμβλύς
沉思	chén sī	διαλογισμός
沉重	chén zhòng	βαρύς
沉着	chén zhuó	ηρεμία
陈旧	chén jiù	απαρχαιωμένος
陈列	chén liè	απεικόνιση
陈述	chén shù	δήλωση
称心如意	chèn xīn rú yì	ικανοποιητικός
衬托	chèn tuō	συμψηφίσει
称号	chēng hào	τίτλος
乘	chéng	πολλαπλασιάζω
呈现	chéng xiàn	παρόν
城堡	chéng bǎo	κάστρο
惩罚	chéng fá	τιμωρία
成本	chéng běn	κόστος
成交	chéng jiāo	συμφωνία
成天	chéng tiān	ολη μέρα
成效	chéng xiào	αποτελεσματικότητα
成心	chéng xīn	επίτηδες
成员	chéng yuán	μέλος
承办	chéng bàn	αναλαμβάνω
承包	chéng bāo	σύμβαση
承诺	chéng nuò	αφοσιωμένος σε
橙	chéng	πορτοκάλι
澄清	chéng qīng	διευκρινίζω
盛	chéng	σενγκ
诚挚	chéng zhì	ειλικρινής
秤	chèng	ζυγός
吃苦	chī kǔ	υποφέρω
吃力	chī lì	κουραστικός
持久	chí jiǔ	διαρκής
迟钝	chí dùn	αργός
迟缓	chí huǎn	αργός
迟疑	chí yí	διστάζω
赤道	chì dào	ισημερινού
赤字	chì zì	έλλειμμα
充当	chōng dāng	συμπεριφέρομαι σαν
充沛	chōng pèi	άφθονος
充实	chōng shí	εμπλουτίζω
充足	chōng zú	επαρκής
冲动	chōng dòng	ώθηση
冲击	chōng jī	αποπληξία
冲突	chōng tū	σύγκρουση
崇拜	chóng bài	λατρεία
崇高	chóng gāo	μεγαλείο
崇敬	chóng jìng	σεβασμός
重叠	chóng dié	επικάλυψη
稠密	chóu mì	πυκνός
筹备	chóu bèi	παρασκευή
丑恶	chǒu è	άσχημος
出路	chū lù	διέξοδος
出卖	chū mài	πουλώ
出身	chū shēn	προέλευση
出神	chū shén	εκσταση
出息	chū xi	εξαιρετική
初步	chū bù	προκαταρκτικός
除	chú	εκτός
储备	chǔ bèi	αποθεματικό
储存	chǔ cún	κατάστημα
储蓄	chǔ xù	οικονομίες
处分	chǔ fèn	κύρωση
处境	chǔ jìng	κατάσταση
处置	chǔ zhì	ξεκάνω
触犯	chù fàn	προσβάλλω
川流不息	chuān liú bù xī	σταθερή ροή
穿越	chuān yuè	διασχίζω
传达	chuán dá	μεταφέρω, εκφράζω
传单	chuán dān	αεροπόρος
传授	chuán shòu	διδάσκω
船舶	chuán bó	πλοίο
喘气	chuǎn qì	λαχανιάζω
串	chuàn	σειρά
床单	chuáng dān	σεντόνι
创立	chuàng lì	ιδρύθηκε το
创新	chuàng xīn	καινοτομία
创业	chuàng yè	ξεκινώ επιχείρηση
创作	chuàng zuò	δημιουργία
吹牛	chuī niú	καύχημα
吹捧	chuī pěng	κολακεύω
炊烟	chuī yān	μαγειρική καπνός
垂直	chuí zhí	κατακόρυφος
锤	chuí	σφυρί
纯粹	chún cuì	καθαρώς
纯洁	chún jié	καθαρος
慈善	cí shàn	φιλάνθρωπος
慈祥	cí xiáng	ευγενώς
磁带	cí dài	ταινία-κασέτα
雌雄	cí xióng	αρσενικό και θηλυκό
伺候	cì hòu	σερβίρισμα
刺	cì	αγκάθι
次品	cì pǐn	ελαττωματικός
次序	cì xù	σειρά
丛	cóng	συστάδα δέντρων
从容	cóng róng	ήρεμα
凑合	còu he	αυτοσχεδιάζω
粗鲁	cū lǔ	αγενής
窜	cuàn	κανάλι
摧残	cuī cán	καταστροφή
脆弱	cuì ruò	εύθραυστο
搓	cuō	συστροφή
磋商	cuō shāng	διαβούλευση
挫折	cuò zhé	εκνευρισμός
搭	dā	παίρνω
搭档	dā dàng	εταίρος
搭配	dā pèi	αγώνας
答辩	dá biàn	απάντηση
答复	dá fù	απάντηση
达成	dá chéng	φθάνω
打包	dǎ bāo	μπάλλα
打官司	dǎ guān si	δίκη
打击	dǎ jī	πλήγμα
打架	dǎ jià	πάλη
打量	dǎ liang	κυτάζω
打猎	dǎ liè	κυνήγι
打仗	dǎ zhàng	πάλη
大不了	dà bù liǎo	μεγάλο θέμα
大臣	dà chén	υπουργός
大伙儿	dà huǒ r	ολοι
大肆	dà sì	απρόθυμα
大体	dà tǐ	γενικά
大意	dà yì	κύρια ιδέα
大致	dà zhì	κατά προσέγγιση
歹徒	dǎi tú	γκάνγκστερ
代价	dài jià	κόστος
代理	dài lǐ	πληρεξούσιο
带领	dài lǐng	οδηγω
怠慢	dài màn	παραμέληση
逮捕	dài bǔ	σύλληψη
担保	dān bǎo	εγγύηση
胆怯	dǎn qiè	συνεσταλμένος
淡季	dàn jì	εκτός εποχής
淡水	dàn shuǐ	γλυκό νερό
蛋白质	dàn bái zhì	πρωτεΐνη
诞辰	dàn chén	γενέθλια
诞生	dàn shēng	γεννημένος
当场	dāng chǎng	επί τόπου
当初	dāng chū	στην αρχή
当代	dāng dài	σύγχρονος
当面	dāng miàn	πρόσωπο με πρόσωπο
当前	dāng qián	ρεύμα
当事人	dāng shì rén	κόμμα
当务之急	dāng wù zhī jí	επιτακτικός
当选	dāng xuǎn	εκλέχθηκε
党	dǎng	κόμμα
档案	dàng àn	αρχείο
档次	dàng cì	βαθμός
倒闭	dǎo bì	κατάρρευση
导弹	dǎo dàn	βλήμα
导航	dǎo háng	πλοήγηση
导向	dǎo xiàng	οδηγός
捣乱	dǎo luàn	κάνω ζημιές, φασαρίες κ.τ.λ
盗窃	dào qiè	κλοπή
稻谷	dào gǔ	αναποφλοίωτο ρύζι
得不偿失	dé bù cháng shī	δεν αξίζει την απώλεια
得力	dé lì	αποτελεσματικός
得天独厚	dé tiān dú hòu	ευλογημένος
得罪	dé zuì	προσβάλλω
灯笼	dēng lóng	φανός
登录	dēng lù	σύνδεση
登陆	dēng lù	συνδεθείτε
蹬	dēng	λάκτισμα
等候	děng hòu	αναμονή
等级	děng jí	βαθμός
瞪	dèng	κοιτάζω
堤坝	dī bà	φράγμα
敌视	dí shì	εχθρικός
抵达	dǐ dá	άφιξη
抵抗	dǐ kàng	αντίσταση
抵制	dǐ zhì	αντιστέκομαι
地步	dì bù	σημείο
地势	dì shì	έδαφος
地质	dì zhì	γεωλογία
递增	dì zēng	αυξήσουν
颠簸	diān bǒ	προσκρούσεις
颠倒	diān dǎo	αντιστροφη
典礼	diǎn lǐ	τελετή
典型	diǎn xíng	τυπικός
点缀	diǎn zhuì	καλλωπισμός
垫	diàn	μπλοκ
奠定	diàn dìng	λαϊκός
惦记	diàn jì	ανησυχώ για
电源	diàn yuán	παροχή ηλεκτρικού ρεύματος
叼	diāo	κουνιέμαι
雕刻	diāo kè	γλυπτική
雕塑	diāo sù	γλυπτική
吊	diào	κρεμάω
调动	diào dòng	κινητοποιώ
跌	diē	πτώση
丁	dīng	κωδώνισμα
叮嘱	dīng zhǔ	προτρέπω
盯	dīng	κοιτάζω
定期	dìng qī	τακτικός
定义	dìng yì	ορισμός
丢人	diū rén	ντροπή
丢三落四	diū sān là sì	χάσε τα πάντα
东道主	dōng dào zhǔ	πλήθος
东张西望	dōng zhāng xī wàng	κοιτάω τριγύρω
董事长	dǒng shì zhǎng	πρόεδρος
冻结	dòng jié	πάγωμα
动荡	dòng dàng	αναταραχή
动机	dòng jī	κίνητρο
动静	dòng jìng	κίνηση
动力	dòng lì	εξουσία
动脉	dòng mài	αρτηρία
动身	dòng shēn	άδεια
动手	dòng shǒu	χέρια
动态	dòng tài	δυναμικός
动员	dòng yuán	κινητοποίηση
栋	dòng	ψωλή
兜	dōu	τσέπη
陡峭	dǒu qiào	απότομος
斗争	dòu zhēng	πάλη
督促	dū cù	παροτρύνω
毒品	dú pǐn	φάρμακο
独裁	dú cái	δικτατορία
堵塞	dǔ sè	εμφραξη
赌博	dǔ bó	τυχερα παιχνιδια
杜绝	dù jué	βάζω τέλος σε
端	duān	τέλος
端午节	duān wǔ jié	φεστιβάλ dragon boat
端正	duān zhèng	σωστός
短促	duǎn cù	μικρός
断定	duàn dìng	καθορίσει
断绝	duàn jué	αποκόβω
堆积	duī jī	συσσώρευση
兑现	duì xiàn	μετρητά
对策	duì cè	αντίμετρα
对称	duì chèn	συμμετρία
对付	duì fu	ασχολούμαι με
对抗	duì kàng	αντιμετώπιση
对立	duì lì	αντιπολίτευση
对联	duì lián	δίστιχο
对应	duì yìng	ανταποκρίνομαι
对照	duì zhào	ελεγχος
队伍	duì wu	ομάδα
顿时	dùn shí	ξαφνικά
哆嗦	duō suo	τρόμος
多元化	duō yuán huà	διαποικίληση
堕落	duò luò	διεφθαρμένος
额外	é wài	πρόσθετος
恶心	ě xin	ναυτία
恶化	è huà	αλλοίωση
遏制	è zhì	περιέχω
恩怨	ēn yuàn	μνησικακία
而已	ér yǐ	αυτό είναι
二氧化碳	èr yǎng huà tàn	διοξείδιο του άνθρακα
发布	fā bù	ελευθέρωση
发财	fā cái	γίνε πλούσιος
发呆	fā dāi	σάστισμα
发动	fā dòng	εκτόξευση
发觉	fā jué	εύρημα
发射	fā shè	εκπομπή
发誓	fā shì	ορκίζομαι
发行	fā xíng	εκδόθηκε
发炎	fā yán	πυρετός
发扬	fā yáng	μεταφέρουν
发育	fā yù	ανάπτυξη
法人	fǎ rén	νομικό προσωπο
番	fān	ανεμιστήρας
凡是	fán shì	όλα
繁华	fán huá	γεμάτο ζωή
繁忙	fán máng	απασχολημένος
繁体字	fán tǐ zì	παραδοσιακά κινεζικά
繁殖	fán zhí	ράτσα
反驳	fǎn bó	αντικρούω
反常	fǎn cháng	ασυνήθιστος
反感	fǎn gǎn	αντιπάθεια
反抗	fǎn kàng	επανάσταση
反馈	fǎn kuì	ανατροφοδότηση
反面	fǎn miàn	αρνητικός
反射	fǎn shè	αντανάκλαση
反思	fǎn sī	αντανάκλαση
反问	fǎn wèn	ρητορική ερώτηση
反之	fǎn zhī	αντιθέτως
泛滥	fàn làn	πλημμύρα
范畴	fàn chóu	κατηγορία
贩卖	fàn mài	πουλώ
方位	fāng wèi	θέση
方言	fāng yán	διάλεκτος
方圆	fāng yuán	φανγκιουάν
方针	fāng zhēn	πολιτική
防守	fáng shǒu	αμυντικός
防御	fáng yù	άμυνα
防止	fáng zhǐ	αποτρέψει
防治	fáng zhì	ελεγχος
纺织	fǎng zhī	υφασμα
访问	fǎng wèn	πρόσβαση
放大	fàng dà	μεγέθυνση
放射	fàng shè	ακτινοβολία
非法	fēi fǎ	παράνομος
飞禽走兽	fēi qín zǒu shòu	πουλιά και θηρία
飞翔	fēi xiáng	πετώ
飞跃	fēi yuè	πηδάω
肥沃	féi wò	εύφορος
诽谤	fěi bàng	δυσφήμηση
废除	fèi chú	κατάργηση
废寝忘食	fèi qǐn wàng shí	αγρυπνος
废墟	fèi xū	ερείπια
沸腾	fèi téng	βρασμός
肺	fèi	πνεύμονας
分辨	fēn biàn	διακρίνω
分寸	fēn cun	μετρούν
分红	fēn hóng	μερίσματα
分解	fēn jiě	έπαθε βλάβη
分裂	fēn liè	διαίρεση
分泌	fēn mì	έκκριση
分明	fēn míng	διακριτή
分歧	fēn qí	διαφωνία
分散	fēn sàn	διασπορά
吩咐	fēn fù	σειρά
坟墓	fén mù	τάφος
粉末	fěn mò	σκόνη
粉色	fěn sè	ροζ
粉碎	fěn suì	σπάσιμο
分量	fèn liàng	τμήμα
愤怒	fèn nù	θυμός
丰满	fēng mǎn	γεμάτος
丰盛	fēng shèng	πλούσιος
丰收	fēng shōu	συγκομιδή προφυλακτήρα
封闭	fēng bì	κλειστό
封建	fēng jiàn	φεουδαρχικός
封锁	fēng suǒ	αποκλεισμός
锋利	fēng lì	αιχμηρός
风暴	fēng bào	καταιγίδα
风度	fēng dù	συμπεριφορά
风光	fēng guāng	τοπίο
风气	fēng qì	ατμόσφαιρα
风趣	fēng qù	αστείος
风土人情	fēng tǔ rén qíng	τοπικά έθιμα
风味	fēng wèi	γεύση
逢	féng	κάθε
奉献	fèng xiàn	αφιέρωση
否决	fǒu jué	βέτο
夫妇	fū fù	ζευγάρι
夫人	fū ren	κυρία
敷衍	fū yǎn	επιπόλαιος
俘虏	fú lǔ	αιχμάλωτος
幅度	fú dù	εύρος
服从	fú cóng	υπακούω
服气	fú qì	πεισμένος
福利	fú lì	ευημερία
福气	fú qi	ευλογία
符号	fú hào	σύμβολο
辐射	fú shè	ακτινοβολία
俯视	fǔ shì	κοίτα κάτω
抚摸	fǔ mō	χαϊδεύοντας
抚养	fǔ yǎng	υψώνω
腐败	fǔ bài	διαφθορά
腐烂	fǔ làn	σαπίλα
腐蚀	fǔ shí	διάβρωση
腐朽	fǔ xiǔ	φθορά
辅助	fǔ zhù	βοηθώ
副	fù	μέγγενη
复活	fù huó	ανάσταση
复兴	fù xīng	αναβίωση
富裕	fù yù	πλούσιος
腹泻	fù xiè	διάρροια
覆盖	fù gài	κάλυμμα
负担	fù dān	βάρος
赋予	fù yǔ	δίνω
附和	fù hè	συμβιβαζομαι, παω με
附件	fù jiàn	παράρτημα
附属	fù shǔ	συνημμένο
改良	gǎi liáng	βελτιώσει
盖章	gài zhāng	σφραγίδα
钙	gài	ασβέστιο
尴尬	gān gà	αδέξιος
干旱	gān hàn	ξηρασία
干扰	gān rǎo	παρέμβαση
干涉	gān shè	βάλτε το κουπί του
干预	gān yù	παρέμβαση
感慨	gǎn kǎi	στεναγμός
感染	gǎn rǎn	μόλυνση
干劲	gàn jìn	ενθουσιασμός
扛	gāng	μεταφέρω
纲领	gāng lǐng	πρόγραμμα
岗位	gǎng wèi	θέση
港口	gǎng kǒu	λιμάνι
港湾	gǎng wān	λιμάνι
杠杆	gàng gǎn	μοχλός
高超	gāo chāo	υπέροχος
高潮	gāo cháo	κορύφωση
高峰	gāo fēng	κορυφή
高明	gāo míng	έξυπνος
高尚	gāo shàng	ευγενής
高涨	gāo zhǎng	υψούμενος
稿件	gǎo jiàn	χειρόγραφο
告辞	gào cí	αποχαιρετισμός
告诫	gào jiè	νουθετώ
割	gē	τομή
搁	gē	βάζω
歌颂	gē sòng	επαινος
疙瘩	gē da	σπυρί
鸽子	gē zi	περιστέρι
格局	gé jú	πρότυπο
格式	gé shì	μορφή
隔阂	gé hé	χάσμα
隔离	gé lí	απομόνωση
革命	gé mìng	επανάσταση
个体	gè tǐ	άτομο
各抒己见	gè shū jǐ jiàn	εκφράστε τις απόψεις τους
根深蒂固	gēn shēn dì gù	βαθιά ριζωμένος
根源	gēn yuán	πηγή
跟前	gēn qián	μπροστά απο
跟随	gēn suí	ακολουθηστε
跟踪	gēn zōng	πίστα
更新	gēng xīn	εκσυγχρονίζω
更正	gēng zhèng	σωστός
耕地	gēng dì	καλλιεργήσιμη γη
供不应求	gōng bù yìng qiú	σε λιγοστό απόθεμα
供给	gōng jǐ	προμήθεια
公安局	gōng ān jú	γραφείο δημόσιας ασφάλειας
公道	gōng dào	δικαιοσύνη
公告	gōng gào	ανακοίνωση
公关	gōng guān	pr
公民	gōng mín	πολίτης
公然	gōng rán	φανερά
公认	gōng rèn	αποδεκτό
公式	gōng shì	τύπος
公务	gōng wù	επίσημη επιχείρηση
公正	gōng zhèng	μόλις
公证	gōng zhèng	συμβολαιογραφική πράξη
功劳	gōng láo	πίστωση
功效	gōng xiào	αποτέλεσμα
宫殿	gōng diàn	παλάτι
工艺品	gōng yì pǐn	χειροτεχνία
恭敬	gōng jìng	γεμάτος σεβασμό
攻击	gōng jī	επίθεση
攻克	gōng kè	πιάνω
巩固	gǒng gù	παγιώνω
共和国	gòng hé guó	δημοκρατία
共计	gòng jì	σύνολο
共鸣	gòng míng	απήχηση
勾结	gōu jié	συνομιλία
钩子	gōu zi	άγκιστρο
构思	gòu sī	ιδέα
姑且	gū qiě	διστακτικά
孤独	gū dú	μοναχικός
孤立	gū lì	απομονωμένος
辜负	gū fù	απογοητεύω
古董	gǔ dǒng	αντίκα
古怪	gǔ guài	εκκεντρικός
股东	gǔ dōng	μέτοχος
股份	gǔ fèn	μερίδια
骨干	gǔ gàn	σπονδυλική στήλη
鼓动	gǔ dòng	ταράζω
固然	gù rán	φυσικά
固体	gù tǐ	στερεός
固有	gù yǒu	συμφυής
固执	gù zhi	πεισματάρης
故乡	gù xiāng	σπίτι
故障	gù zhàng	δυσλειτουργία
雇佣	gù yōng	ενοικίαση
顾虑	gù lv4	ανησυχία
顾问	gù wèn	σύμβουλος
拐杖	guǎi zhàng	δεκανίκι
关怀	guān huái	φροντίδα
关照	guān zhào	φροντίδα
官方	guān fāng	επίσημος
观光	guān guāng	βλέπω τα αξιοθέατα
管辖	guǎn xiá	δικαιοδοσία
惯例	guàn lì	σύμβαση
灌溉	guàn gài	άρδευση
罐	guàn	δεξαμενή
贯彻	guàn chè	υλοποιώ, εφαρμόζω
光彩	guāng cǎi	ενδοξος
光辉	guāng huī	ενδοξος
光芒	guāng máng	φως
光荣	guāng róng	δόξα
广阔	guǎng kuò	ευρύς
归根到底	guī gēn dào dǐ	στην τελική ανάλυση
归还	guī huán	επιστροφη
规范	guī fàn	προσδιορισμός
规格	guī gé	προσδιορισμός
规划	guī huà	σχεδίαση
规章	guī zhāng	κανονισμοί
轨道	guǐ dào	πίστα
贵族	guì zú	ευγενής
跪	guì	γονατίζω
棍棒	gùn bàng	ραβδί
国防	guó fáng	εθνική άμυνα
国务院	guó wù yuàn	κρατικό συμβούλιο
果断	guǒ duàn	αποφασιστικός
过度	guò dù	πάνω από
过渡	guò dù	μετάβαση
过奖	guò jiǎng	υπερβολικό
过滤	guò lv4	φίλτρο
过失	guò shī	σφάλμα
过问	guò wèn	παρεμβαίνω
过瘾	guò yǐn	απολαυστικός
过于	guò yú	πολύ
嗨	hāi	γεια
海拔	hǎi bá	υψόμετρο
海滨	hǎi bīn	παραλία
含糊	hán hu	ασαφής
含义	hán yì	έννοια
寒暄	hán xuān	χαιρετισμός
罕见	hǎn jiàn	σπάνιος
捍卫	hàn wèi	υπερασπίζω
航空	háng kōng	αεροπορία
航天	háng tiān	αεροδιαστημική
航行	háng xíng	ιστιοπλοΐα
行列	háng liè	βαθμοί
毫米	háo mǐ	μαμ
毫无	háo wú	τίποτα
豪迈	háo mài	ηρωϊκός
号召	hào zhào	ζητώ
耗费	hào fèi	κόστος
呵	hē	αχ
合并	hé bìng	συγχώνευση
合成	hé chéng	σύνθεση
合伙	hé huǒ	συνεταιρισμός
合算	hé suàn	αποδοτική
和蔼	hé ǎi	είδος
和解	hé jiě	συμφιλίωση
和睦	hé mù	αρμονία
和气	hé qi	καλοσύνη
和谐	hé xié	αρμονικός
嘿	hēi	γεια
痕迹	hén jì	ίχνος
狠心	hěn xīn	άκαρδος
恨不得	hèn bu dé	δεν μπορώ να περιμένω
哼	hēng	ωχ
横	héng	οριζόντιος
哄	hōng	καταφέρνω
烘	hōng	ψήνω
轰动	hōng dòng	αίσθηση
宏观	hóng guān	μακροεντολή
宏伟	hóng wěi	μεγαλοπρεπής
洪水	hóng shuǐ	πλημμύρα
喉咙	hóu lóng	λαιμός
吼	hǒu	βρυχηθμός
候选	hòu xuǎn	υποψήφιος
后代	hòu dài	απόγονος
后顾之忧	hòu gù zhī yōu	ανησυχίες
后勤	hòu qín	επιμελητεία
呼唤	hū huàn	κλήση
呼啸	hū xiào	ουρλιάζω
呼吁	hū yù	κλήση
忽略	hū lvè	αγνοώ
湖泊	hú pō	λίμνη
胡乱	hú luàn	ανέμελα
胡须	hú xū	γενειάδα
花瓣	huā bàn	πέταλο
花蕾	huā lěi	μπουμπούκι
华丽	huá lì	υπέροχος
华侨	huá qiáo	στο εξωτερικό κινεζικά
划分	huà fēn	διαιρέστε
化肥	huà féi	λίπασμα
化石	huà shí	απολίθωμα
化验	huà yàn	χημική δοκιμή
化妆	huà zhuāng	μακιγιάζ
画蛇添足	huà shé tiān zú	περιττός
话筒	huà tǒng	μικρόφωνο
欢乐	huān lè	χαρά
环节	huán jié	σύνδεσμος
还原	huán yuán	μείωση
缓和	huǎn hé	ευκολία
患者	huàn zhě	υπομονετικος
荒凉	huāng liáng	έρημος
荒谬	huāng miù	παράλογος
荒唐	huāng táng	παράλογος
皇帝	huáng dì	αυτοκράτορας
皇后	huáng hòu	βασίλισσα
黄昏	huáng hūn	σούρουπο
恍然大悟	huǎng rán dà wù	ξαφνικά συνειδητοποίησα
晃	huǎng	σέικ
挥霍	huī huò	φιγούρα
辉煌	huī huáng	λαμπρός
回报	huí bào	επιστροφη
回避	huí bì	αποφύγει
回顾	huí gù	ανασκόπηση
回收	huí shōu	ανακυκλωνω
悔恨	huǐ hèn	τύψη συνειδήσεως
毁灭	huǐ miè	καταστρέφω
会晤	huì wù	συνάντηση
汇报	huì bào	κανω αναφορα
贿赂	huì lù	δωροδοκία
昏迷	hūn mí	κώμα
荤	hūn	κρέας
浑身	hún shēn	παντού
混合	hùn hé	μίξη
混乱	hùn luàn	σύγχυση
混淆	hùn xiáo	συγχέω
混浊	hùn zhuó	θολός
活该	huó gāi	αξίζουν
活力	huó lì	ζωτικότητα
火箭	huǒ jiàn	ρουκέτα
火焰	huǒ yàn	φλόγα
火药	huǒ yào	πυρίτιδα
货币	huò bì	νόμισμα
基地	jī dì	βάση
基金	jī jīn	κεφάλαιο
基因	jī yīn	γονίδιο
机动	jī dòng	ελιγμός
机构	jī gòu	μηχανισμός
机灵	jī ling	έξυπνος
机密	jī mì	εμπιστευτικός
机械	jī xiè	μηχανικός
机遇	jī yù	ευκαιρία
机智	jī zhì	πνευματώδης
激发	jī fā	διέγερση
激励	jī lì	διέγερση
激情	jī qíng	πάθος
讥笑	jī xiào	χλεύη
饥饿	jī è	πείνα
即便	jí biàn	ακόμα κι αν
即将	jí jiāng	ερχομαι συντομα
及早	jí zǎo	νωρίς
吉祥	jí xiáng	ευοίωνος
嫉妒	jí dù	ζηλιάρης
急功近利	jí gōng jìn lì	γρήγορη επιτυχία
急剧	jí jù	αιχμηρός
急切	jí qiè	πρόθυμος
急于求成	jí yú qiú chéng	πρόθυμος για επιτυχία
急躁	jí zào	ανυπόμονος
极端	jí duān	άκρο
极限	jí xiàn	όριο
疾病	jí bìng	ασθένεια
籍贯	jí guàn	ιδιαίτερη πατρίδα
级别	jí bié	επίπεδο
集团	jí tuán	ομάδα
给予	jǐ yǔ	δίνω
季军	jì jūn	τρίτη θέση
季度	jì dù	τριμηνιαίος
寂静	jì jìng	σιωπή
寄托	jì tuō	εμπιστεύομαι
忌讳	jì huì	ταμπού
技巧	jì qiǎo	επιδεξιότητα
纪要	jì yào	περίληψη
继承	jì chéng	κληρονομώ
计较	jì jiào	νοιαζομαι για
记性	jì xing	μνήμη
记载	jì zǎi	ρεκόρ
迹象	jì xiàng	σημάδι
佳肴	jiā yáo	λιχουδιά
加工	jiā gōng	επεξεργασία
加剧	jiā jù	εντείνω
夹杂	jiā zá	συμπερίληψη
家常	jiā cháng	ασχημος
家伙	jiā huo	ο τύπος
家属	jiā shǔ	μέλη της οικογένειας
家喻户晓	jiā yù hù xiǎo	πολύ γνωστό
坚定	jiān dìng	εταιρεία
坚固	jiān gù	εταιρεία
坚韧	jiān rèn	σκληρός
坚实	jiān shí	στερεός
坚硬	jiān yìng	σκληρά
尖端	jiān duān	υπόδειξη
尖锐	jiān ruì	αιχμηρός
煎	jiān	τηγανητό
监督	jiān dū	επιβλέπω
监视	jiān shì	οθόνη
监狱	jiān yù	φυλακή
艰难	jiān nán	δύσκολος
剪彩	jiǎn cǎi	κόψτε την κορδέλα
拣	jiǎn	διαλέγω
检讨	jiǎn tǎo	ανασκόπηση
检验	jiǎn yàn	δοκιμή
简化	jiǎn huà	απλοποιώ
简陋	jiǎn lòu	ακατέργαστος
简体字	jiǎn tǐ zì	απλοποιημένα κινέζικα
简要	jiǎn yào	σύντομος
健全	jiàn quán	ήχος
剑	jiàn	σπαθί
溅	jiàn	βουτιά
舰艇	jiàn tǐng	πλοίο
见多识广	jiàn duō shí guǎng	γνώστης
见解	jiàn jiě	γνώμη
见闻	jiàn wén	η γνώση
见义勇为	jiàn yì yǒng wéi	δικαιολογώ
践踏	jiàn tà	τσαλαπατώ
鉴别	jiàn bié	αναγνωρίζω
鉴定	jiàn dìng	ταυτοποίηση
鉴于	jiàn yú	δεδομένος
间谍	jiàn dié	κατάσκοπος
间隔	jiàn gé	διάστημα
间接	jiàn jiē	έμμεσος
僵硬	jiāng yìng	δύσκαμπτος
将军	jiāng jūn	γενικός
将近	jiāng jìn	σχεδόν
将就	jiāng jiù	θα είναι
奖励	jiǎng lì	ανταμοιβή
奖赏	jiǎng shǎng	ανταμοιβή
桨	jiǎng	κουπί
降临	jiàng lín	ελα
交叉	jiāo chā	σταυρός
交代	jiāo dài	εξηγώ
交涉	jiāo shè	διαπραγμάτευση
交易	jiāo yì	συναλλαγή
娇气	jiāo qì	τάση προς εμετό
焦点	jiāo diǎn	συγκεντρώνω
焦急	jiāo jí	ανήσυχος
侥幸	jiǎo xìng	τυχερός
搅拌	jiǎo bàn	ταραχή
缴纳	jiǎo nà	πληρωμή
角落	jiǎo luò	γωνία
教养	jiào yǎng	ανατροφή
较量	jiào liàng	διαγωνισμός
接连	jiē lián	μαζεύω
揭露	jiē lù	εκθέτω
皆	jiē	όλα
阶层	jiē céng	τάξη
截止	jié zhǐ	αποκόβω
截至	jié zhì	από
杰出	jié chū	εξαιρετική
竭尽全力	jié jìn quán lì	βάλε τα δυνατά σου
结晶	jié jīng	αποκρυστάλλωση
结局	jié jú	κατάληξη
结算	jié suàn	επίλυση
节制	jié zhì	έλεγχος
节奏	jié zòu	ρυθμός
解除	jiě chú	απολύω
解放	jiě fàng	απελευθέρωση
解雇	jiě gù	απόλυση
解剖	jiě pōu	ανατομία
解散	jiě sàn	απολύω
解体	jiě tǐ	αποσύνθεση
借鉴	jiè jiàn	δανείζομαι
借助	jiè zhù	με τη βοήθεια του
戒备	jiè bèi	συναγερμός
界限	jiè xiàn	όριο
津津有味	jīn jīn yǒu wèi	με απόλαυση
金融	jīn róng	χρηματοοικονομική
紧迫	jǐn pò	επείγων
锦上添花	jǐn shàng tiān huā	γλάσο στην τούρτα
晋升	jìn shēng	προβολή
浸泡	jìn pào	μουλιάζω
近来	jìn lái	πρόσφατα
进而	jìn ér	και μετά
进攻	jìn gōng	επίθεση
进化	jìn huà	εξέλιξη
进展	jìn zhǎn	πρόοδος
兢兢业业	jīng jīng yè yè	ευσυνείδητος
惊动	jīng dòng	διαταράσσει
惊奇	jīng qí	εκπληξη
惊讶	jīng yà	εκπληκτος
精打细算	jīng dǎ xì suàn	προγραμματίστε προσεκτικά
精华	jīng huá	ουσία
精简	jīng jiǎn	εξορθολογισμός
精密	jīng mì	ακρίβεια
精确	jīng què	ακριβής
精通	jīng tōng	εντριβής
精心	jīng xīn	επεξεργάζομαι
精益求精	jīng yì qiú jīng	συνεχίστε να βελτιώνεστε
精致	jīng zhì	πανέμορφος
经费	jīng fèi	χρηματοδότηση
经纬	jīng wěi	γεωγραφικό πλάτος και μήκος
茎	jīng	στέλεχος
井	jǐng	καλά
警告	jǐng gào	ανακοπή
警惕	jǐng tì	συναγερμός
颈椎	jǐng zhuī	αυχενική σπονδυλική στήλη
境界	jìng jiè	βασίλειο
敬礼	jìng lǐ	χαιρετισμός
敬业	jìng yè	αφιερωμένο
竞赛	jìng sài	ανταγωνισμός
竞选	jìng xuǎn	καμπάνια
镜头	jìng tóu	φακός
纠纷	jiū fēn	διαμάχη
纠正	jiū zhèng	σωστός
酒精	jiǔ jīng	αλκοόλ
就近	jiù jìn	πλησίον
就业	jiù yè	εργασία
就职	jiù zhí	εγκαίνια
救济	jiù jì	ανακούφιση
居民	jū mín	οι κατοικοι
居住	jū zhù	ζω
拘留	jū liú	κράτηση στη φυλακή
拘束	jū shù	συγκράτηση
鞠躬	jū gōng	τόξο
局部	jú bù	μερικός
局面	jú miàn	κατάσταση
局势	jú shì	κατάσταση
局限	jú xiàn	περιορισμοί
举动	jǔ dòng	κίνηση
举世瞩目	jǔ shì zhǔ mù	προσελκύστε παγκόσμια προσοχή
举足轻重	jǔ zú qīng zhòng	κεντρικός
咀嚼	jǔ jué	μασάω
沮丧	jǔ sàng	απογοητευμένοι
剧本	jù běn	γραφή
剧烈	jù liè	αυστηρός
据悉	jù xī	αναφέρεται ότι
聚精会神	jù jīng huì shén	συγκεντρώνομαι
卷	juǎn	ενταση ηχου
倔强	jué jiàng	πεισματάρης
决策	jué cè	λήψη αποφάσης
绝望	jué wàng	απελπισία
觉悟	jué wù	συνείδηση
觉醒	jué xǐng	αφύπνιση
军队	jūn duì	στρατός
君子	jūn zǐ	κύριος
卡通	kǎ tōng	κοινουμενα σχεδια
开采	kāi cǎi	εξόρυξη
开除	kāi chú	απελάθηκε
开阔	kāi kuò	άνοιξε
开朗	kāi lǎng	χαρούμενος
开明	kāi míng	φωτισμένος
开辟	kāi pì	ανοίγω
开拓	kāi tuò	ανοίγω
开展	kāi zhǎn	αναπτύσσω
开支	kāi zhī	δαπάνη
刊登	kān dēng	δημοσιεύω
刊物	kān wù	δημοσίευση
勘探	kān tàn	εξερεύνηση
侃侃而谈	kǎn kǎn ér tán	μιλήστε ελεύθερα
砍伐	kǎn fá	κατάρριψη
看待	kàn dài	κυτάζω
慷慨	kāng kǎi	γενναιόδωρος
抗议	kàng yì	διαμαρτυρία
考察	kǎo chá	επισκόπηση
考古	kǎo gǔ	αρχαιολογία
考核	kǎo hé	εκτίμηση
考验	kǎo yàn	δοκιμή
靠拢	kào lǒng	ελα πιο κοντά
磕	kē	χτύπημα
科目	kē mù	θέμα
可观	kě guān	σημαντικός
可口	kě kǒu	γευστικός
可恶	kě wù	μισητός
可行	kě xíng	εφικτός
渴望	kě wàng	επιθυμία
克制	kè zhì	συγκράτηση
刻不容缓	kè bù róng huǎn	δεν υπάρχει χρόνος για καθυστέρηση
客户	kè hù	πελάτης
课题	kè tí	θέμα
啃	kěn	δάγκωμα
恳切	kěn qiè	ειλικρινής
坑	kēng	λάκκος
空洞	kōng dòng	κοίλος
空前绝后	kōng qián jué hòu	πρωτοφανής
空想	kōng xiǎng	φαντασία
空虚	kōng xū	κενότητα
孔	kǒng	τρύπα
恐怖	kǒng bù	τρόμος
恐吓	kǒng hè	εκφοβίζω
恐惧	kǒng jù	φόβος
空白	kòng bái	κενό
空隙	kòng xì	χάσμα
口气	kǒu qì	τόνος
口腔	kǒu qiāng	στοματική κοιλότητα
口头	kǒu tóu	από το στόμα
口音	kǒu yīn	προφορά
扣	kòu	πόρπη
哭泣	kū qì	κραυγή
枯萎	kū wěi	μαραμένο
枯燥	kū zào	αμβλύς
苦尽甘来	kǔ jìn gān lái	πικρία
苦涩	kǔ sè	πικρός
挎	kuà	μεταφέρω
跨	kuà	σπιθαμή
快活	kuài huo	ευτυχισμένος
宽敞	kuān chang	ευρύχωρος
宽容	kuān róng	ανεκτικός
款待	kuǎn dài	φιλοξενία
款式	kuǎn shì	στυλ
筐	kuāng	καλάθι
况且	kuàng qiě	εκτός
旷课	kuàng kè	κατά συνήθεια απουσία
框架	kuàng jià	πλαίσιο
矿产	kuàng chǎn	ορυκτό
亏待	kuī dài	αντιμετωπίστε άσχημα
亏损	kuī sǔn	απώλεια
捆绑	kǔn bǎng	δεμένο
扩充	kuò chōng	επέκταση
扩散	kuò sàn	διάχυση
扩张	kuò zhāng	επέκταση
啦	lā	λα
喇叭	lǎ ba	ομιλητής
蜡烛	là zhú	κερί
来历	lái lì	προέλευση
来源	lái yuán	πηγή
栏目	lán mù	στήλη
懒惰	lǎn duò	τεμπέλης
狼狈	láng bèi	αμήχανος
狼吞虎咽	láng tūn hǔ yàn	λύκος
捞	lāo	ψάρι
唠叨	láo dao	γκρίνια
牢固	láo gù	εταιρεία
牢骚	láo sāo	γογγυσμός
乐趣	lè qù	ευχαρίστηση
乐意	lè yì	πρόθυμος
雷达	léi dá	ραντάρ
类似	lèi sì	παρόμοιος
冷酷	lěng kù	σκληρός
冷落	lěng luò	έφυγε
冷却	lěng què	κρυώνω
愣	lèng	παγωμένο
黎明	lí míng	αυγή
理睬	lǐ cǎi	δώσε προσοχή στο
理所当然	lǐ suǒ dāng rán	φυσικά
理直气壮	lǐ zhí qì zhuàng	ειλικρινής
理智	lǐ zhì	λόγος
礼节	lǐ jié	εθιμοτυπία
礼尚往来	lǐ shàng wǎng lái	αμοιβαιότητα
里程碑	lǐ chéng bēi	ορόσημο
例外	lì wài	εξαίρεση
利害	lì hài	στοίχημα
力求	lì qiú	μοχθώ για
力所能及	lì suǒ néng jí	μέσα στη δύναμή μας
力争	lì zhēng	προσπαθώ
历代	lì dài	ιστορία
历来	lì lái	πάντα
立场	lì chǎng	θέση
立方	lì fāng	κύβος
立交桥	lì jiāo qiáo	υπερυψωμένη διάβαση
立体	lì tǐ	τρισδιάστατο
立足	lì zú	στάσου
粒	lì	σιτηρά
廉洁	lián jié	καθαρη
联欢	lián huān	συναντιέμαι
联络	lián luò	σύνδεση
联盟	lián méng	συμμαχια
联想	lián xiǎng	lenovo
连年	lián nián	χρόνο με το χρόνο
连锁	lián suǒ	αλυσίδα
连同	lián tóng	μαζί με
良心	liáng xīn	συνείδηση
晾	liàng	αέρας
谅解	liàng jiě	κατανόηση
辽阔	liáo kuò	απέραντος
列举	liè jǔ	απαριθμώ
临床	lín chuáng	κλινικός
淋	lín	ντους
吝啬	lìn sè	τσιγκούνης
伶俐	líng lì	εξυπνος
凌晨	líng chén	νωρίς το πρωί
灵感	líng gǎn	έμπνευση
灵魂	líng hún	ψυχή
灵敏	líng mǐn	ευαίσθητος
零星	líng xīng	σποραδικός
领会	lǐng huì	καταλαβαίνουν
领事馆	lǐng shì guǎn	προξενείο
领土	lǐng tǔ	έδαφος
领悟	lǐng wù	κατανοώ
领先	lǐng xiān	οδηγω
领袖	lǐng xiù	ηγέτης
溜	liū	γλιστράω
流浪	liú làng	περιπλάνηση
流露	liú lù	αποκαλύπτω
流氓	liú máng	κατεργάρης
流通	liú tōng	κυκλοφορία
留恋	liú liàn	νοσταλγία
留念	liú niàn	ενθύμιο
留神	liú shén	πρόσεχε
聋哑	lóng yǎ	κουφός και χαζός
隆重	lóng zhòng	μεγαλειώδης
垄断	lǒng duàn	μονοπώλιο
笼罩	lǒng zhào	τυλιγμένος
搂	lǒu	αγκαλιάζω
炉灶	lú zào	κουζίνα
轮船	lún chuán	βαπόρι
轮廓	lún kuò	περίγραμμα
轮胎	lún tāi	ελαστικά
论坛	lùn tán	δικαστήριο
论证	lùn zhèng	διαφωνία
啰唆	luō suo	ενοχλητικός
络绎不绝	luò yì bù jué	ατελείωτη ροή
落成	luò chéng	ολοκληρώθηκε το
落实	luò shí	υλοποιώ, εφαρμόζω
屡次	lv3 cì	κατ 'επανάληψη
履行	lv3 xíng	εκπληρώ
掠夺	lvè duó	λεηλασία
嘛	ma	καλά
麻痹	má bì	παράλυση
麻木	má mù	μούδιασμα
麻醉	má zuì	αναισθησία
码头	mǎ tóu	αποβάθρα
蚂蚁	mǎ yǐ	μυρμήγκι
埋伏	mái fú	ενέδρα
埋没	mái mò	θαμμένος
埋葬	mái zàng	θάβω
脉搏	mài bó	σφυγμός
迈	mài	βήμα
埋怨	mán yuàn	κανω παραπονα
慢性	màn xìng	χρόνιος
漫长	màn cháng	μακρύς
漫画	màn huà	ιστορία σε εικόνες
蔓延	màn yán	εξάπλωση
忙碌	máng lù	απασχολημένος
盲目	máng mù	με κλειστά μάτια
茫茫	máng máng	απέραντος
茫然	máng rán	σε μια απώλεια
冒充	mào chōng	υποδύομαι
冒犯	mào fàn	προσβάλλω
茂盛	mào shèng	κόσμημα
媒介	méi jiè	μεσαίο
枚	méi	κομμάτια
美观	měi guān	πανεμορφη
美满	měi mǎn	ευτυχισμένος
美妙	měi miào	εκπληκτικός
萌芽	méng yá	μπουμπούκι
猛烈	měng liè	βίαιος
眯	mī	στραβισμός
弥补	mí bǔ	μακιγιάζ
弥漫	mí màn	διαχέω
谜语	mí yǔ	αίνιγμα
迷惑	mí huo	συγχέω
迷人	mí rén	γοητευτικός
迷信	mí xìn	δεισιδαιμονία
密度	mì dù	πυκνότητα
密封	mì fēng	σφραγίδα
棉花	mián hua	βαμβάκι
免得	miǎn de	μήπως
免疫	miǎn yì	ασυλία, ανοσία
勉励	miǎn lì	ενθαρρύνω
勉强	miǎn qiǎng	απρόθυμα
面貌	miàn mào	πρόσωπο
面子	miàn zi	πρόσωπο
描绘	miáo huì	περιγράφω
瞄准	miáo zhǔn	σκοπός
渺小	miǎo xiǎo	μικρό
藐视	miǎo shì	περιφρόνηση
灭亡	miè wáng	χάνομαι
蔑视	miè shì	περιφρόνηση
民间	mín jiān	παραδοσιακός
民主	mín zhǔ	δημοκρατία
敏捷	mǐn jié	ευκίνητος
敏锐	mǐn ruì	οξύς
名次	míng cì	σειρά κατάταξης
名额	míng é	ποσοστό
名副其实	míng fù qí shí	αξίζει το όνομα
名誉	míng yù	φήμη
明明	míng míng	προφανώς
明智	míng zhì	σοφός
命名	mìng míng	όνομα
摸索	mō suo	ψαχούλεμα
摩擦	mó cā	τριβή
模范	mó fàn	μοντέλο
模式	mó shì	τρόπος
模型	mó xíng	μοντέλο
磨合	mó hé	πέφτω πάνω
膜	mó	μεμβράνη
魔鬼	mó guǐ	διάβολος
魔术	mó shù	μαγεία
抹杀	mǒ shā	σβήνω
墨水儿	mò shuǐ r	μελάνι
莫名其妙	mò míng qí miào	δυσάρεστο
默默	mò mò	σιωπηλά
谋求	móu qiú	ψάχνω
模样	mú yàng	εμφάνιση
母语	mǔ yǔ	μητρική γλώσσα
沐浴	mù yù	περιλούω
目睹	mù dǔ	μάρτυρας
目光	mù guāng	κοίτα
拿手	ná shǒu	καλός
纳闷儿	nà mèn r	αναρωτιέμαι
耐用	nài yòng	διαρκής
南辕北辙	nán yuán běi zhé	αποκλίνων
难得	nán dé	σπάνιος
难堪	nán kān	αμήχανος
难能可贵	nán néng kě guì	αξιέπαινος
恼火	nǎo huǒ	ενοχλημένος
内涵	nèi hán	εννοια
内幕	nèi mù	εσωτερική ιστορία
内在	nèi zài	εσωτερικός
能量	néng liàng	ενέργεια
拟定	nǐ dìng	ανασηκώνομαι
逆行	nì xíng	παλινδρομικός
年度	nián dù	έτος
捏	niē	πρέζα
凝固	níng gù	στερεοποίηση
凝聚	níng jù	συνοχή
凝视	níng shì	βλέμμα
拧	níng	βίδα
宁肯	nìng kěn	μάλλον
宁愿	nìng yuàn	θα προτιμούσα
扭转	niǔ zhuǎn	συστροφή
纽扣儿	niǔ kòu r	κουμπιά
农历	nóng lì	σεληνιακό ημερολόγιο
浓厚	nóng hòu	ισχυρός
奴隶	nú lì	δούλος
挪	nuó	κίνηση
虐待	nvè dài	κατάχρηση
哦	ò	ω
殴打	ōu dǎ	ρυθμός
偶像	ǒu xiàng	είδωλο
呕吐	ǒu tù	έμετος
趴	pā	ψέμα
徘徊	pái huái	περιπλάνηση
排斥	pái chì	αποκρούω
排除	pái chú	αποκλείω
排放	pái fàng	εκπομπή
排练	pái liàn	επαναλαμβάνω
派别	pài bié	φατρία
派遣	pài qiǎn	στείλετε
攀登	pān dēng	η ανάβαση
盘旋	pán xuán	κύκλος
判决	pàn jué	κρίση
畔	pàn	τράπεζα
庞大	páng dà	τεράστιος
抛弃	pāo qì	εγκαταλείπω
泡沫	pào mò	αφρός
培育	péi yù	ανατροφή
配备	pèi bèi	εξοπλισμένο
配偶	pèi ǒu	σύζυγος
配套	pèi tào	ταιριάζει
盆地	pén dì	λεκάνη
烹饪	pēng rèn	μαγείρεμα
捧	pěng	κρατήστε
劈	pī	άμαξα προς μίσθωση
批发	pī fā	χονδρικο εμποριο
批判	pī pàn	κριτική
疲惫	pí bèi	εξαντλημένος
疲倦	pí juàn	κουρασμένος
皮革	pí gé	δέρμα
屁股	pì gu	βαρέλι
譬如	pì rú	για παράδειγμα
偏差	piān chā	απόκλιση
偏见	piān jiàn	προκατάληψη
偏僻	piān pì	μακρινός
偏偏	piān piān	αντιθέτως
片断	piàn duàn	θραύσμα
片刻	piàn kè	στιγμή
漂浮	piāo fú	φλοτέρ
飘扬	piāo yáng	ταραχή
撇	piē	αποβουτύρωση
拼搏	pīn bó	σκληρή δουλειά
拼命	pīn mìng	απεγνωσμένα
贫乏	pín fá	φτωχός
贫困	pín kùn	φτωχός
频繁	pín fán	συχνά
频率	pín lv4	συχνότητα
品尝	pǐn cháng	γεύση
品德	pǐn dé	χαρακτήρας
品质	pǐn zhì	ποιότητα
品种	pǐn zhǒng	ποικιλία
屏幕	píng mù	οθόνη
屏障	píng zhàng	εμπόδιο
平凡	píng fán	συνήθης
平面	píng miàn	διαμέρισμα
平坦	píng tǎn	διαμέρισμα
平行	píng xíng	παράλληλο
平庸	píng yōng	μέτριος
平原	píng yuán	πεδιάδα
评估	píng gū	εκτίμηση
评论	píng lùn	σχόλιο
坡	pō	κλίση
泼	pō	βουτιά
颇	pō	αρκετά
破例	pò lì	κάντε μια εξαίρεση
迫不及待	pò bù jí dài	δεν μπορώ να περιμένω
迫害	pò hài	καταδίωξη
魄力	pò lì	θάρρος
扑	pū	ταραχή
铺	pū	κατάστημα
普及	pǔ jí	παγκόσμιος
朴实	pǔ shí	απλός
朴素	pǔ sù	απλός
瀑布	pù bù	υδατόπτωση
凄凉	qī liáng	έρημος
期望	qī wàng	αναμένω
期限	qī xiàn	ο όρος
欺负	qī fu	νταής
欺骗	qī piàn	εξαπατώ
奇妙	qí miào	εκπληκτικός
旗袍	qí páo	cheongsam
旗帜	qí zhì	πανό
歧视	qí shì	διάκριση
齐全	qí quán	πλήρης
齐心协力	qí xīn xié lì	συνεργαστούν
乞丐	qǐ gài	ζητιάνος
企图	qǐ tú	απόπειρα
启程	qǐ chéng	συμψηφίσει
启蒙	qǐ méng	διαφώτιση
启事	qǐ shì	ειδοποίηση
启示	qǐ shì	διαφώτιση
岂有此理	qǐ yǒu cǐ lǐ	παράλογος
起草	qǐ cǎo	σύνταξη
起初	qǐ chū	αρχικά
起伏	qǐ fú	σκαμπανεβάσματα
起哄	qǐ hòng	booing
起码	qǐ mǎ	τουλάχιστον
起源	qǐ yuán	προέλευση
器材	qì cái	εξοπλισμός
器官	qì guān	όργανο
气概	qì gài	πνεύμα
气功	qì gōng	τσιγκόνγκ
气魄	qì pò	τολμηρός
气色	qì sè	χροιά
气势	qì shì	ορμή
气味	qì wèi	οσμή
气象	qì xiàng	μετεωρολογικός
气压	qì yā	πίεση αέρα
气质	qì zhí	ιδιοσυγκρασία
迄今为止	qì jīn wéi zhǐ	μέχρι τώρα
掐	qiā	πρέζα
恰当	qià dàng	κατάλληλος
恰到好处	qià dào hǎo chù	ακριβώς δεξιά
恰巧	qià qiǎo	συμπτωματικά
洽谈	qià tán	διαπραγματεύομαι
千方百计	qiān fāng bǎi jì	κάντε ό, τι είναι δυνατόν
牵	qiān	οδηγω
牵扯	qiān chě	εμπλέκω
牵制	qiān zhì	περιέχω
签署	qiān shǔ	σημάδι
谦逊	qiān xùn	ταπεινός
迁就	qiān jiù	φιλοξενώ
迁徙	qiān xǐ	μετανάστευση
前景	qián jǐng	προοπτική
前提	qián tí	προϋπόθεση
潜力	qián lì	δυνητικός
潜水	qián shuǐ	καταδύσεις
潜移默化	qián yí mò huà	αδιανόητα
谴责	qiǎn zé	καταδικάζω
抢劫	qiāng jié	ληστεία
强制	qiáng zhì	επιτακτικός
强迫	qiǎng pò	δύναμη
抢救	qiǎng jiù	διάσωση
桥梁	qiáo liáng	γέφυρα
窍门	qiào mén	τέχνασμα
翘	qiào	αλίκη
切实	qiè shí	πρακτικός
锲而不舍	qiè ér bù shě	επιμονή
亲密	qīn mì	κλείσε
亲热	qīn rè	στοργικός
侵犯	qīn fàn	παραβιάζω
侵略	qīn lvè	επίθεση
钦佩	qīn pèi	θαυμασμός
勤俭	qín jiǎn	σκληρά εργαζόμενος
勤劳	qín láo	εργατικός
倾听	qīng tīng	ακούω
倾向	qīng xiàng	τάση
倾斜	qīng xié	γέρνω
清澈	qīng chè	σαφή
清晨	qīng chén	νωρίς το πρωί
清除	qīng chú	σαφή
清洁	qīng jié	καθαρη
清理	qīng lǐ	καθάρισε
清晰	qīng xī	σαφή
清醒	qīng xǐng	εξυπνότατος
清真	qīng zhēn	μουσουλμάνος
情报	qíng bào	νοημοσύνη
情节	qíng jié	οικόπεδο
情理	qíng lǐ	έννοια
情形	qíng xíng	κατάσταση
晴朗	qíng lǎng	ηλιόλουστος
请柬	qǐng jiǎn	πρόσκληση
请教	qǐng jiào	συμβουλεύομαι
请示	qǐng shì	ζητήστε οδηγίες
请帖	qǐng tiě	πρόσκληση
丘陵	qiū líng	λόφους
区分	qū fēn	διακρίνω
区域	qū yù	περιοχή
屈服	qū fú	απόδοση παραγωγής
曲折	qū zhé	ελικοειδής
驱逐	qū zhú	αποβάλλω
渠道	qú dào	κανάλι
取缔	qǔ dì	απαγόρευση
曲子	qǔ zi	τραγούδι
趣味	qù wèi	γεύση
圈套	quān tào	παγίδα
全局	quán jú	παγκόσμια
全力以赴	quán lì yǐ fù	βγες έξω
拳头	quán tou	γροθιά
权衡	quán héng	ανταλλαγή
权威	quán wēi	εξουσία
犬	quǎn	σκύλος
缺口	quē kǒu	χάσμα
缺席	quē xí	απουσία
缺陷	quē xiàn	ελάττωμα
瘸	qué	κουτσός
确保	què bǎo	συγουρεύομαι
确立	què lì	εγκαθιδρύω
确切	què qiè	ακριβής
确信	què xìn	πεισμένος
群众	qún zhòng	οι μάζες
染	rǎn	βαφή
嚷	rǎng	κραυγή
让步	ràng bù	παραχώρηση
饶恕	ráo shù	συγχωρώ
扰乱	rǎo luàn	διαταράσσει
惹祸	rě huò	δικαστική καταστροφή
热泪盈眶	rè lèi yíng kuàng	δάκρυα στα μάτια
热门	rè mén	δημοφιλής
人道	rén dào	ανθρώπινος
人格	rén gé	προσωπικότητα
人工	rén gōng	τεχνητός
人家	rén jia	ανθρωποι
人间	rén jiān	κόσμος
人士	rén shì	πρόσωπο
人为	rén wéi	τεχνητός
人性	rén xìng	ανθρώπινη φύση
人质	rén zhì	όμηρος
仁慈	rén cí	καλοσύνη
忍耐	rěn nài	υπομονή
忍受	rěn shòu	υποφέρω
任命	rèn mìng	ραντεβού
任性	rèn xìng	ιδιότροπος
任意	rèn yì	αυθαίρετος
任重道远	rèn zhòng dào yuǎn	πολύς δρόμος
认定	rèn dìng	αναγνωρίζω
认可	rèn kě	αναγνωρισμένος
仍旧	réng jiù	ακόμη
日新月异	rì xīn yuè yì	αλλαγή με κάθε μέρα που περνά
日益	rì yì	όλο και περισσότερο
容貌	róng mào	εμφάνιση
容纳	róng nà	φιλοξενώ
容器	róng qì	δοχείο
容忍	róng rěn	ανέχομαι
溶解	róng jiě	διαλύω
荣幸	róng xìng	με ευχαρίστηση
荣誉	róng yù	τιμή
融化	róng huà	τήκω
融洽	róng qià	συμπάθεια
揉	róu	τρίψιμο
柔和	róu hé	μαλακός
儒家	rú jiā	κομφουκιανισμός
弱点	ruò diǎn	αδυναμία
若干	ruò gān	αρκετά
撒谎	sā huǎng	ψέμα
散文	sǎn wén	πεζός λόγος
散布	sàn bù	εξάπλωση
散发	sàn fā	διανέμω
丧失	sàng shī	χάνω
骚扰	sāo rǎo	παρενοχλούν
嫂子	sǎo zi	κουνιάδα
刹车	shā chē	φρένο
啥	shá	τι
筛选	shāi xuǎn	φίλτρο
山脉	shān mài	βουνά
闪烁	shǎn shuò	αναβοσβήνει
擅长	shàn cháng	καλός σε
擅自	shàn zì	ανεξουσιοδότητος
伤脑筋	shāng nǎo jīn	ενοχλητικός
商标	shāng biāo	εμπορικό σήμα
上级	shàng jí	ανώτερος
上进	shàng jìn	θέτω στην κίνησιν
上任	shàng rèn	αναλαμβάνω την εξουσία
上瘾	shàng yǐn	εθισμένος
上游	shàng yóu	αντίθετα στο ρεύμα
尚且	shàng qiě	ακόμη
捎	shāo	παίρνω μαζί
梢	shāo	υπόδειξη
哨	shào	θέση
奢侈	shē chǐ	πολυτέλεια
舌头	shé tou	γλώσσα
摄氏度	shè shì dù	κελσίου
涉及	shè jí	εμπλεγμένος
社区	shè qū	κοινότητα
设立	shè lì	στήνω
设想	shè xiǎng	φαντάζομαι
设置	shè zhì	στήνω
呻吟	shēn yín	γκρίνια
深奥	shēn ào	βαθύς
深沉	shēn chén	βαθύς
深情厚谊	shēn qíng hòu yì	βαθιά φιλία
申报	shēn bào	δηλώνω
绅士	shēn shì	κύριος
神经	shén jīng	νεύρο
神奇	shén qí	μαγικός
神气	shén qì	αέρας
神圣	shén shèng	ιερός
神态	shén tài	συμπεριφορά
神仙	shén xiān	αθάνατος
审查	shěn chá	ανασκόπηση
审理	shěn lǐ	δίκη
审美	shěn měi	αισθητικός
审判	shěn pàn	δίκη
慎重	shèn zhòng	προσεκτικός
渗透	shèn tòu	διείσδυση
声明	shēng míng	δήλωση
声势	shēng shì	ορμή
声誉	shēng yù	φήμη
牲畜	shēng chù	ζώα
生存	shēng cún	επιζώ
生机	shēng jī	ζωτικότητα
生理	shēng lǐ	φυσιολογικός
生疏	shēng shū	σκουριασμένος
生态	shēng tài	οικολογία
生物	shēng wù	βιολογικός
生效	shēng xiào	τεθούν σε ισχύ
生肖	shēng xiào	ζωδιακός κύκλος
生锈	shēng xiù	σκουριά
生育	shēng yù	γονιμότητα
省会	shěng huì	επαρχιακή πρωτεύουσα
盛产	shèng chǎn	πλούσιος
盛开	shèng kāi	ανθίζω
盛情	shèng qíng	φιλοξενία
盛行	shèng xíng	επικρατώ
胜负	shèng fù	κερδίζω ή χάνω
失事	shī shì	ναυάγιο
失误	shī wù	λάθος
失踪	shī zōng	λείπει
尸体	shī tǐ	νεκρό σώμα
师范	shī fàn	δάσκαλος
施加	shī jiā	επιβάλλω
施展	shī zhǎn	απεικόνιση
十足	shí zú	γεμάτος
实惠	shí huì	προμηθευτός
实力	shí lì	δύναμη
实施	shí shī	υλοποιώ, εφαρμόζω
实事求是	shí shì qiú shì	αναζητήστε την αλήθεια από τα γεγονότα
实行	shí xíng	υλοποιώ, εφαρμόζω
实质	shí zhì	ουσία
拾	shí	μαζεύω
时常	shí cháng	συχνά
时而	shí ér	ωρες ωρες
时光	shí guāng	χρόνος
时机	shí jī	ευκαιρία
时事	shí shì	τρέχοντα γεγονότα
石油	shí yóu	λάδι
识别	shí bié	αναγνωρίζω
使命	shǐ mìng	αποστολή
世代	shì dài	γενιές
事故	shì gù	ατύχημα
事迹	shì jì	πράξεις
事件	shì jiàn	εκδήλωση
事态	shì tài	κατάσταση
事务	shì wù	υποθέσεις
事项	shì xiàng	ύλη
事业	shì yè	αιτία
势必	shì bì	δεσμεύεται να
势力	shì li	εξουσία
是非	shì fēi	σωστό ή λάθος
示范	shì fàn	επίδειξη
示威	shì wēi	επίδειξη
示意	shì yì	σήμα
视力	shì lì	όραμα
视频	shì pín	βίντεο
视线	shì xiàn	θέαμα
视野	shì yě	οραμα
试图	shì tú	απόπειρα
试验	shì yàn	δοκιμή
适宜	shì yí	κατάλληλος
逝世	shì shì	πεθαίνω
释放	shì fàng	ελευθερώθηκε
收藏	shōu cáng	αγαπημένα
收缩	shōu suō	μαζεύω
收益	shōu yì	εισόδημα
收音机	shōu yīn jī	ραδιόφωνο
守护	shǒu hù	φρουρά
手法	shǒu fǎ	τεχνική
手势	shǒu shì	χειρονομία
手艺	shǒu yì	σκάφος
首饰	shǒu shì	κοσμήματα
首要	shǒu yào	πρωταρχικός
受罪	shòu zuì	υποφέρω
授予	shòu yǔ	χορήγηση
书法	shū fǎ	καλλιγραφία
书记	shū ji	γραμματέας
书籍	shū jí	βιβλία
书面	shū miàn	γραπτός
疏忽	shū hu	αμέλεια
疏远	shū yuǎn	απαλλοτριώ
舒畅	shū chàng	ανετος
数额	shù é	ποσό
束	shù	δέσμη
束缚	shù fù	δουλεία
树立	shù lì	στήνω
竖	shù	κατακόρυφος
耍	shuǎ	παίζω
衰老	shuāi lǎo	γηρασμός
衰退	shuāi tuì	πτώση
率领	shuài lǐng	οδηγω
涮火锅	shuàn huǒ guō	σαμπού σαμπού
双胞胎	shuāng bāo tāi	δίδυμο
爽快	shuǎng kuài	πρόθυμα
水利	shuǐ lì	συντήρηση νερού
水龙头	shuǐ lóng tóu	βρύση
水泥	shuǐ ní	τσιμέντο
瞬间	shùn jiān	στιγμή
司法	sī fǎ	δικαστικός
司令	sī lìng	διοικητής
思念	sī niàn	δεσποινίδα
思索	sī suǒ	σκέψη
思维	sī wéi	σκέψη
斯文	sī wen	ευγενής
私自	sī zì	ιδιαιτερώς
死亡	sǐ wáng	θάνατος
四肢	sì zhī	άκρα
寺庙	sì miào	ναός
肆无忌惮	sì wú jì dàn	ασυνείδητος
饲养	sì yǎng	εκτροφή
耸	sǒng	πανυψηλός
艘	sōu	πλοίο
苏醒	sū xǐng	ίχνη
俗话	sú huà	αργκό
塑造	sù zào	σχήμα
素食	sù shí	φαγητο χορτοφαγων
素质	sù zhì	ποιότητα
诉讼	sù sòng	δίκη
算数	suàn shù	μετρώ
随即	suí jí	αμέσως
随意	suí yì	τυχαίος
岁月	suì yuè	χρόνια
隧道	suì dào	σήραγγα
损坏	sǔn huài	βλάβη
索取	suǒ qǔ	αίτηση
索性	suǒ xìng	απλά
塌	tā	κατάρρευση
踏实	tā shi	σταθερός
塔	tǎ	πύργος
台风	tái fēng	τυφώνας
太空	tài kōng	χώρος
泰斗	tài dǒu	πρύτανης
摊	tān	αναβάλλω
瘫痪	tān huàn	παράλυση
贪婪	tān lán	άπληστος
贪污	tān wū	διαφθορά
弹性	tán xìng	ελαστικότητα
坦白	tǎn bái	ειλικρινής
叹气	tàn qì	στεναγμός
探测	tàn cè	ανιχνεύουν
探索	tàn suǒ	εξερευνώ
探讨	tàn tǎo	εξερευνώ
探望	tàn wàng	επίσκεψη
倘若	tǎng ruò	αν
掏	tāo	σκάβω
滔滔不绝	tāo tāo bù jué	μιλήστε ατελείωτα
淘汰	táo tài	εξαλείφθηκε
陶瓷	táo cí	κεραμικά
陶醉	táo zuì	διασκεδάζω
讨好	tǎo hǎo	σας παρακαλούμε
特长	tè cháng	ειδικότητα
特定	tè dìng	ειδικός
特意	tè yì	ειδικώς
提拔	tí bá	προωθείται
提炼	tí liàn	διύλιση
提示	tí shì	προτροπή
提议	tí yì	πρόταση
题材	tí cái	θέμα
体裁	tǐ cái	είδος
体积	tǐ jī	ενταση ηχου
体谅	tǐ liàng	διακριτικός
体面	tǐ miàn	κόσμιος
体系	tǐ xì	σύστημα
天才	tiān cái	ιδιοφυία
天赋	tiān fù	ταλέντο
天伦之乐	tiān lún zhī lè	οικογενειακή διασκέδαση
天然气	tiān rán qì	φυσικό αέριο
天生	tiān shēng	γεννημένος
天堂	tiān táng	παράδεισος
天文	tiān wén	αστρονομικό
田径	tián jìng	κομμάτι και πεδίο
田野	tián yě	πεδίο
舔	tiǎn	γλείψιμο
挑剔	tiāo ti	επιλεκτικοί
条款	tiáo kuǎn	οροι
条理	tiáo lǐ	διοργάνωσε
条约	tiáo yuē	συνθήκη
调和	tiáo hé	συμφιλίωση
调剂	tiáo jì	προσαρμόζω
调节	tiáo jié	προσαρμόζω
调解	tiáo jiě	μεσολάβηση
调料	tiáo liào	καρύκευμα
挑拨	tiǎo bō	παίζω
挑衅	tiǎo xìn	προκλητικός
跳跃	tiào yuè	άλμα
亭子	tíng zi	περίπτερο
停泊	tíng bó	παρκαρισμένο
停顿	tíng dùn	παύση
停滞	tíng zhì	στάσιμος
挺拔	tǐng bá	ψηλό και ίσιο
通货膨胀	tōng huò péng zhàng	πληθωρισμός
通缉	tōng jī	καταζητούμενος
通俗	tōng sú	δημοφιλής
通讯	tōng xùn	επικοινωνία
通用	tōng yòng	παγκόσμιος
同胞	tóng bāo	αμφιθαλής αδελφός
同志	tóng zhì	γκέι
童话	tóng huà	παραμύθι
铜	tóng	χαλκός
统筹兼顾	tǒng chóu jiān gù	συνολικός προγραμματισμός
统计	tǒng jì	στατιστική
统统	tǒng tǒng	όλα
统治	tǒng zhì	κανόνας
投机	tóu jī	κερδοσκοπία
投票	tóu piào	ψήφος
投诉	tóu sù	καταγγελία
投降	tóu xiáng	παράδοση
投掷	tóu zhì	βολή
透露	tòu lù	αποκαλύπτω
秃	tū	φαλακρός
突破	tū pò	ανακάλυψη
图案	tú àn	πρότυπο
徒弟	tú dì	μαθητευόμενος
涂抹	tú mǒ	κηλίδα
途径	tú jìng	τρόπος
土壤	tǔ rǎng	έδαφος
团结	tuán jié	ενότητα
团体	tuán tǐ	ομάδα
团圆	tuán yuán	επανένωση
推测	tuī cè	σκέπτομαι
推翻	tuī fān	ανατροπή
推理	tuī lǐ	αιτιολογία
推论	tuī lùn	συμπέρασμα
推销	tuī xiāo	πουλώ
吞吞吐吐	tūn tūn tǔ tǔ	διστακτικός
托运	tuō yùn	αποστολή
拖延	tuō yán	αναβλητικότητα
脱离	tuō lí	δραπετεύω
妥当	tuǒ dang	κατάλληλος
妥善	tuǒ shàn	κατάλληλος
妥协	tuǒ xié	συμβιβασμός
椭圆	tuǒ yuán	ωοειδής
唾弃	tuò qì	θέτω στην άκρη
哇	wa	ουάου
挖掘	wā jué	σκάβω
娃娃	wá wa	κούκλα
瓦解	wǎ jiě	κατάρρευση
歪曲	wāi qū	διαστροφέας
外表	wài biǎo	εμφάνιση
外行	wài háng	λαϊκός
外界	wài jiè	έξω κόσμος
外向	wài xiàng	εξερχόμενος
丸	wán	χάπι
完备	wán bèi	πλήρης
完毕	wán bì	πλήρης
玩弄	wán nòng	παίζω
玩意儿	wán yì r	πράγμα
顽固	wán gù	πεισματάρης
顽强	wán qiáng	επίμονος
惋惜	wǎn xī	μετανιώνω
挽回	wǎn huí	εξαργυρώνω
挽救	wǎn jiù	αποθηκεύσετε
万分	wàn fēn	επακρώς
往常	wǎng cháng	ως συνήθως
往事	wǎng shì	το παρελθόν
妄想	wàng xiǎng	αυταπάτη
危机	wēi jī	κρίση
威风	wēi fēng	το κύρος
威力	wēi lì	εξουσία
威望	wēi wàng	το κύρος
威信	wēi xìn	το κύρος
微不足道	wēi bù zú dào	αμελητέος
微观	wēi guān	μικρο
为难	wéi nán	αμήχανος
为期	wéi qī	διάρκεια
唯独	wéi dú	μόνος
维持	wéi chí	διατηρούν
维护	wéi hù	διατηρούν
维生素	wéi shēng sù	βιταμίνες
违背	wéi bèi	πηγαινω εναντια
伪造	wěi zào	πλαστογραφία
委托	wěi tuō	επιτροπή
委员	wěi yuán	μέλος επιτροπής
卫星	wèi xīng	δορυφόρος
喂	wèi	γεια σας (ρήμα)
慰问	wèi wèn	συλλυπητήρια
未免	wèi miǎn	αναπόφευκτος
畏惧	wèi jù	φόβος
蔚蓝	wèi lán	γαλανός
温带	wēn dài	εύκρατη ζώνη
温和	wēn hé	ήπιος
文凭	wén píng	δίπλωμα
文物	wén wù	πολιτιστικά λείψανα
文献	wén xiàn	βιβλιογραφία
文雅	wén yǎ	κομψός
文艺	wén yì	τέχνη
问世	wèn shì	βγαίνω έξω
窝	wō	φωλιά
乌黑	wū hēi	τζετ μαύρο
污蔑	wū miè	συκοφαντία
诬陷	wū xiàn	πλαίσιο
无比	wú bǐ	επακρώς
无偿	wú cháng	ελεύθερος
无耻	wú chǐ	αναίσχυντος
无动于衷	wú dòng yú zhōng	αδιάφορος
无非	wú fēi	τίποτα περισσότερο από
无辜	wú gū	αθώος
无精打采	wú jīng dǎ cǎi	αδιάφορος
无赖	wú lài	κατεργάρης
无理取闹	wú lǐ qǔ nào	παράλογος
无能为力	wú néng wéi lì	ανίσχυρος
无穷无尽	wú qióng wú jìn	ατελείωτες
无微不至	wú wēi bù zhì	λεπτολόγος
无忧无虑	wú yōu wú lv4	ανέμελος
无知	wú zhī	άγνοια
侮辱	wǔ rǔ	προσβολή
武器	wǔ qì	όπλα
武侠	wǔ xiá	πολεμικές τέχνες
武装	wǔ zhuāng	ενοπλος
舞蹈	wǔ dǎo	χορός
务必	wù bì	να είσαι σίγουρος
物美价廉	wù měi jià lián	καλή ποιότητα και φθηνό
物业	wù yè	ιδιοκτησία
物资	wù zī	προμήθειες
误差	wù chā	λάθος
误解	wù jiě	παρεξήγηση
夕阳	xī yáng	η δυση του ηλιου
昔日	xī rì	παλιές μέρες
溪	xī	ποταμάκι
熄灭	xī miè	πήγαινε έξω
牺牲	xī shēng	θυσία
膝盖	xī gài	γόνατο
习俗	xí sú	έθιμο
媳妇	xí fu	νύφη
袭击	xí jī	προσβολή
喜闻乐见	xǐ wén lè jiàn	λατρεύω να ακούω
喜悦	xǐ yuè	χαρά
系列	xì liè	σειρά
细菌	xì jūn	βακτηριακός
细胞	xì bāo	κύτταρο
细致	xì zhì	λεπτολόγος
峡谷	xiá gǔ	φαράγγι
狭隘	xiá ài	στενός
狭窄	xiá zhǎi	στενός
霞	xiá	σια
下属	xià shǔ	υφιστάμενος
先进	xiān jìn	προχωρημένος
先前	xiān qián	προηγουμένως
掀起	xiān qǐ	συμψηφίσει
纤维	xiān wéi	ίνα
鲜明	xiān míng	λαμπρός
嫌	xián	αντιπάθεια
嫌疑	xián yí	υποπτος
弦	xián	σειρά
衔接	xián jiē	σύνδεση
贤惠	xián huì	ενάρετος
闲话	xián huà	κουτσομπολιό
显著	xiǎn zhù	σημαντικός
宪法	xiàn fǎ	σύνταγμα
现场	xiàn chǎng	στην ιστοσελιδα
现成	xiàn chéng	έτοιμο
现状	xiàn zhuàng	καθεστώς
线索	xiàn suǒ	ένδειξη
陷害	xiàn hài	πλαισιωμένο
陷阱	xiàn jǐng	παγίδα
陷入	xiàn rù	πέφτω μέσα
馅儿	xiàn r	γέμιση
乡镇	xiāng zhèn	δήμος
相差	xiāng chà	διαφορά
相等	xiāng děng	ίσος
相辅相成	xiāng fǔ xiāng chéng	συμπληρώστε ο ένας τον άλλον
相应	xiāng yìng	αντίστοιχος
镶嵌	xiāng qiàn	μωσαϊκό
响亮	xiǎng liàng	μεγαλόφωνος
响应	xiǎng yìng	απάντηση
想方设法	xiǎng fāng shè fǎ	βρείτε τρόπους
向导	xiàng dǎo	οδηγός
向来	xiàng lái	πάντα
向往	xiàng wǎng	λαχταρούν για
巷	xiàng	λωρίδα
相声	xiàng sheng	στιχομυθία
消除	xiāo chú	εξαλείφω
消毒	xiāo dú	απολυμαίνω
消防	xiāo fáng	πυρόσβεση
消耗	xiāo hào	καταναλώνω
消灭	xiāo miè	σβήνω
潇洒	xiāo sǎ	σικ
销毁	xiāo huǐ	καταστρέφω
小心翼翼	xiǎo xīn yì yì	προσεκτικά
效益	xiào yì	όφελος
肖像	xiào xiàng	πορτρέτο
协会	xié huì	σχέση
协商	xié shāng	διαπραγματεύομαι
协调	xié tiáo	συντονισμός
协议	xié yì	πρωτόκολλο
协助	xié zhù	βοηθώ
携带	xié dài	μεταφέρω
屑	xiè	ψίχουλα
泄露	xiè lù	δώσουν τη θέση τους
泄气	xiè qì	αποθαρρυνμένος
谢绝	xiè jué	πτώση
心得	xīn dé	εμπειρία
心甘情愿	xīn gān qíng yuàn	οικειοθελώς
心灵	xīn líng	ψυχή
心态	xīn tài	νοοτροπία
心疼	xīn téng	αγχωμένος
心血	xīn xuè	σκληρή δουλειά
心眼儿	xīn yǎn r	προσεκτικός
新陈代谢	xīn chén dài xiè	μεταβολισμός
新郎	xīn láng	γαμπρός
新娘	xīn niáng	νυφη
新颖	xīn yǐng	μυθιστόρημα
欣慰	xīn wèi	ευχαριστημένος
欣欣向荣	xīn xīn xiàng róng	ευδοκιμούν
薪水	xīn shuǐ	μισθός
辛勤	xīn qín	σκληρή δουλειά
信赖	xìn lài	εμπιστοσύνη
信念	xìn niàn	πίστη
信仰	xìn yǎng	πίστη
信誉	xìn yù	φήμη
兴高采烈	xīng gāo cǎi liè	χαρούμενος
兴隆	xīng lóng	επιτυχημένος
兴旺	xīng wàng	ακμάζουσα
腥	xīng	απίθανος
刑事	xíng shì	εγκληματίας
形态	xíng tài	μορφή
行政	xíng zhèng	διοικητικός
兴致勃勃	xìng zhì bó bó	ενθουσιασμένος
性感	xìng gǎn	λάγνος
性命	xìng mìng	ζωη
性能	xìng néng	εκτέλεση
凶恶	xiōng è	φαύλος
凶手	xiōng shǒu	δολοφόνος
汹涌	xiōng yǒng	ταραχώδης
胸怀	xiōng huái	μυαλό
胸膛	xiōng táng	στήθος
雄厚	xióng hòu	ισχυρός
雄伟	xióng wěi	μεγαλοπρεπής
修复	xiū fù	επισκευή
修建	xiū jiàn	χτίζω
修养	xiū yǎng	εκπαίδευση
羞耻	xiū chǐ	ντροπή
嗅觉	xiù jué	μυρωδιά
绣	xiù	κεντώ
虚假	xū jiǎ	ψευδής
虚荣	xū róng	ματαιοδοξία
虚伪	xū wěi	υποκριτικός
需求	xū qiú	ζήτηση
须知	xū zhī	ειδοποίηση
许可	xǔ kě	άδεια
序言	xù yán	πρόλογος
畜牧	xù mù	κτηνοτροφία
酗酒	xù jiǔ	αλκοολισμός
喧哗	xuān huá	θόρυβος
宣誓	xuān shì	παίρνω όρκο
宣扬	xuān yáng	κηρύττω
悬挂	xuán guà	εναιώρημα
悬念	xuán niàn	αγωνία
悬殊	xuán shū	ανισότητα
悬崖峭壁	xuán yá qiào bì	βραχώδεις ακτές
旋律	xuán lv4	μελωδία
旋转	xuán zhuǎn	γνέθω
选拔	xuǎn bá	επιλογή
选举	xuǎn jǔ	εκλογή
选手	xuǎn shǒu	παίχτης
炫耀	xuàn yào	επίδειξη
削	xuē	τομή
削弱	xuē ruò	αποδυναμώνω
学说	xué shuō	θεωρία
学位	xué wèi	πτυχίο επιστημών
雪上加霜	xuě shàng jiā shuāng	χειρότερος
血压	xuè yā	πίεση αίματος
熏陶	xūn táo	εποικοδομώ
寻觅	xún mì	εύρημα
巡逻	xún luó	περιπολία
循环	xún huán	κύκλος
循序渐进	xún xù jiàn jìn	βήμα βήμα
压迫	yā pò	καταπίεση
压岁钱	yā suì qián	τα χρήματα της πρωτοχρονιάς
压缩	yā suō	συμπίεση
压抑	yā yì	μελαγχολικός
压榨	yā zhà	τύπος
压制	yā zhì	καταστέλλω
鸦雀无声	yā què wú shēng	σιωπηλός
亚军	yà jūn	επιλαχών
淹没	yān mò	βυθισμένος
烟花爆竹	yān huā bào zhú	κροτίδες
严峻	yán jùn	αυστηρός
严寒	yán hán	σοβαρό κρύο
严禁	yán jìn	απαγορεύεται αυστηρά
严厉	yán lì	αυστηρός
严密	yán mì	σφιχτός
岩石	yán shí	βράχος
延期	yán qī	επέκταση
延伸	yán shēn	επεκτείνω
延续	yán xù	να συνεχίσει
沿海	yán hǎi	παραλιακός
炎热	yán rè	ζεστό
言论	yán lùn	ομιλία
掩盖	yǎn gài	κάλυμμα
掩护	yǎn hù	κάλυμμα
掩饰	yǎn shì	συγκάλυψη
演变	yǎn biàn	εξέλιξη
演习	yǎn xí	άσκηση
演绎	yǎn yì	αφαίρεση
演奏	yǎn zòu	παιχνίδι
眼光	yǎn guāng	όραμα
眼色	yǎn sè	κλείσιμο ματιού
眼神	yǎn shén	κοίτα
厌恶	yàn wù	αηδία
验收	yàn shōu	αποδοχή
验证	yàn zhèng	επαλήθευση
氧气	yǎng qì	οξυγόνο
样品	yàng pǐn	δείγμα
摇摆	yáo bǎi	κούνια
摇滚	yáo gǔn	βράχος
谣言	yáo yán	φήμη
遥控	yáo kòng	τηλεχειριστήριο
遥远	yáo yuǎn	μακρινός
耀眼	yào yǎn	εκθαμβωτικός
要点	yào diǎn	σημείο
要命	yào mìng	τρομερός
要素	yào sù	στοιχείο
野蛮	yě mán	κτηνώδης
野心	yě xīn	φιλοδοξία
液体	yè tǐ	υγρό
一流	yī liú	πρώτη τάξη
一如既往	yī rú jì wǎng	όπως πάντα
依旧	yī jiù	ακόμη
依据	yī jù	συμφωνώς προς
依靠	yī kào	βασίζομαι
依赖	yī lài	βασίζομαι
依托	yī tuō	βασίζομαι σε
衣裳	yī shang	ρούχα
一度	yí dù	μια φορά
一贯	yí guàn	σταθερός
一目了然	yí mù liǎo rán	με μια ματιά
一向	yí xiàng	πάντα
仪器	yí qì	όργανο
仪式	yí shì	τελετή
疑惑	yí huò	αμφιβολία
遗产	yí chǎn	κληρονομία
遗传	yí chuán	γενετική
遗留	yí liú	κληρονομιά
遗失	yí shī	χαμένος
以便	yǐ biàn	έτσι ώστε
以免	yǐ miǎn	ώστε να μην γίνει
以往	yǐ wǎng	στο παρελθόν
以至	yǐ zhì	ακόμη και
以致	yǐ zhì	ετσι ώστε
一帆风顺	yì fān fēng shùn	ομαλή πλεύση
一举两得	yì jǔ liǎng dé	σκοτώστε δύο πουλιά με μία πέτρα
一丝不苟	yì sī bù gǒu	λεπτολόγος
亦	yì	επίσης
异常	yì cháng	ασυνήθιστος
意料	yì liào	αναμενόμενος
意识	yì shí	επίγνωση
意图	yì tú	πρόθεση
意味着	yì wèi zhe	σημαίνω
意向	yì xiàng	πρόθεση
意志	yì zhì	θα
毅力	yì lì	επιμονή
毅然	yì rán	απολύτως
翼	yì	πτέρυγα
阴谋	yīn móu	συνωμοσία
音响	yīn xiǎng	ήχος
引导	yǐn dǎo	οδηγός
引擎	yǐn qíng	κινητήρας
引用	yǐn yòng	παραθέτω, αναφορά
隐蔽	yǐn bì	κρυμμένος
隐患	yǐn huàn	κρυμμένος κίνδυνος
隐瞒	yǐn mán	κρύβω
隐私	yǐn sī	μυστικότητα
隐约	yǐn yuē	λιποθυμία
饮食	yǐn shí	διατροφή
婴儿	yīng ér	μωρό
英明	yīng míng	σοφός
英勇	yīng yǒng	ηρωϊκός
盈利	yíng lì	κέρδος
迎面	yíng miàn	με την κεφαλή εμπρός
应酬	yìng chou	καθιστώ κοινωνικόν
应邀	yìng yāo	πρόσκληση
庸俗	yōng sú	χυδαίος
拥护	yōng hù	υποστήριξη
拥有	yōng yǒu	έχω
勇于	yǒng yú	γενναίος
永恒	yǒng héng	αιώνιος
涌现	yǒng xiàn	αναδύομαι
踊跃	yǒng yuè	δραστήρια
用户	yòng hù	χρήστης
优胜劣汰	yōu shèng liè tài	επιβίωση του ισχυρότερου
优先	yōu xiān	προτεραιότητα
优异	yōu yì	εξοχος
优越	yōu yuè	ανώτερος
忧郁	yōu yù	μελαγχολία
油腻	yóu nì	λιπαρός
油漆	yóu qī	χρώμα
犹如	yóu rú	λες και
有条不紊	yǒu tiáo bù wěn	μεθοδικός
幼稚	yòu zhì	αφελής
诱惑	yòu huò	μέσα στον πειρασμό
愚蠢	yú chǔn	ανόητος
愚昧	yú mèi	αγνοια
渔民	yú mín	ψαράδες
舆论	yú lùn	κοινή γνώμη
与日俱增	yǔ rì jù zēng	αυξάνεται μέρα με τη μέρα
宇宙	yǔ zhòu	σύμπαν
羽绒服	yǔ róng fú	κάτω σακάκι
寓言	yù yán	μύθος
愈	yù	θεραπεύω
欲望	yù wàng	επιθυμία
熨	yù	σιδέρωμα
玉	yù	νεφρίτης
预料	yù liào	αναμενόμενος
预期	yù qī	αναμενόμενος
预算	yù suàn	προϋπολογισμός
预先	yù xiān	προκαταβολή
预言	yù yán	προφητεία
预兆	yù zhào	οιωνός
冤枉	yuān wang	λάθος
元首	yuán shǒu	επικεφαλής του κράτους
元素	yuán sù	στοιχείο
元宵节	yuán xiāo jié	φεστιβάλ φαναριών
原告	yuán gào	ενάγων
原理	yuán lǐ	αρχή
原始	yuán shǐ	πρωτότυπο
原先	yuán xiān	πρωτότυπο
园林	yuán lín	κήπος
圆满	yuán mǎn	πλήρης
源泉	yuán quán	πηγή
缘故	yuán gù	λόγος
约束	yuē shù	περιορισμός
乐谱	yuè pǔ	φύλλα μουσικής
岳母	yuè mǔ	πεθερά
孕育	yùn yù	εκτράφηκε
蕴藏	yùn cáng	περιέχω
运算	yùn suàn	υπολογισμός
运行	yùn xíng	τρέξιμο
酝酿	yùn niàng	ζυθοποιία
杂技	zá jì	ακροβασία
杂交	zá jiāo	παραγωγή μικτών γενών
砸	zá	σπάσιμο
咋	zǎ	πως
栽培	zāi péi	καλλιέργεια
灾难	zāi nàn	καταστροφή
宰	zǎi	σφαγή
再接再厉	zài jiē zài lì	κάνουμε επίμονες προσπάθειες
在意	zài yì	φροντίδα
攒	zǎn	αποθηκεύσετε
暂且	zàn qiě	προς το παρόν
赞叹	zàn tàn	θαυμάζω
赞助	zàn zhù	ανάδοχος
糟蹋	zāo tà	λεία
遭受	zāo shòu	υποφέρω
遭殃	zāo yāng	υποφέρω
遭遇	zāo yù	συνάντηση
噪音	zào yīn	θόρυβος
造型	zào xíng	πρίπλασμα
责怪	zé guài	κατηγορώ
贼	zéi	κλέφτης
增添	zēng tiān	προσθήκη
赠送	zèng sòng	χαρίζω
扎	zhā	γραβάτα
扎实	zhā shi	στερεός
渣	zhā	σκωρία
眨	zhǎ	αναβοσβήνω
诈骗	zhà piàn	απάτη
摘要	zhāi yào	περίληψη
债券	zhài quàn	δεσμός
沾光	zhān guāng	βουτιά
瞻仰	zhān yǎng	αποτίστε φόρο τιμής
展示	zhǎn shì	επίδειξη
展望	zhǎn wàng	αποψη
展现	zhǎn xiàn	επίδειξη
崭新	zhǎn xīn	ολοκαίνουργιο
斩钉截铁	zhǎn dīng jié tiě	αποφασιστικά
占据	zhàn jù	ασχολούμαι
占领	zhàn lǐng	κατειλημμένος
战斗	zhàn dòu	μαχητικός
战略	zhàn lvè	στρατηγική
战术	zhàn shù	τακτική
战役	zhàn yì	μάχη
章程	zhāng chéng	ναύλωση
帐篷	zhàng peng	σκηνή
障碍	zhàng ài	εμπόδιο
招标	zhāo biāo	πρόσκληση
招收	zhāo shōu	νεοσύλλεκτος
朝气蓬勃	zhāo qì péng bó	σθεναρός
着迷	zháo mí	γοητευμένος
沼泽	zhǎo zé	τέλμα
照样	zhào yàng	ακόμη
照耀	zhào yào	λάμψη
折腾	zhē teng	τινάσσω
遮挡	zhē dǎng	απορροφώ
折	zhé	πτυχή
折磨	zhé mó	βασανίστηκε
侦探	zhēn tàn	ντεντεκτίβ
斟酌	zhēn zhuó	σκεφτείτε
珍贵	zhēn guì	πολύτιμος
珍稀	zhēn xī	σπάνιος
珍珠	zhēn zhū	μαργαριτάρι
真理	zhēn lǐ	αλήθεια
真相	zhēn xiàng	η αλήθεια
真挚	zhēn zhì	ειλικρινής
枕头	zhěn tou	μαξιλάρι
振奋	zhèn fèn	ανύψωση
振兴	zhèn xīng	αναζωογονώ
镇定	zhèn dìng	ηρεμία
镇静	zhèn jìng	ηρεμία
阵地	zhèn dì	θέση
阵容	zhèn róng	σύνθεση
震撼	zhèn hàn	αποπληξία
震惊	zhèn jīng	αποπληξία
争端	zhēng duān	διαμάχη
争夺	zhēng duó	ισχυρισμός
争气	zhēng qì	νίκη
争先恐后	zhēng xiān kǒng hòu	αναταραχή
争议	zhēng yì	διαμάχη
征服	zhēng fú	κατακτώ
征收	zhēng shōu	συλλογή
挣扎	zhēng zhá	πάλη
正月	zhēng yuè	πρώτος μήνας
蒸发	zhēng fā	εξάτμιση
整顿	zhěng dùn	επανορθώνω
政策	zhèng cè	πολιτική
政权	zhèng quán	καθεστώς
正当	zhèng dāng	αιτιολογημένη
正负	zhèng fù	θετικο και αρνητικο
正规	zhèng guī	τακτικός
正经	zhèng jing	σοβαρός
正气	zhèng qì	νομιμότητα
正义	zhèng yì	δικαιοσύνη
正宗	zhèng zōng	αυθεντικός
症状	zhèng zhuàng	σύμπτωμα
证实	zhèng shí	επιβεβαιώνω
证书	zhèng shū	πιστοποιητικό
郑重	zhèng zhòng	επίσημα
之际	zhī jì	στην περιπτωση
支撑	zhī chēng	υποστήριξη
支出	zhī chū	δαπάνη
支流	zhī liú	παραπόταμος
支配	zhī pèi	κατακυριεύω
支援	zhī yuán	υποστήριξη
支柱	zhī zhù	κολόνα
枝	zhī	κλαδί
知觉	zhī jué	αντίληψη
知足常乐	zhī zú cháng lè	ικανοποίηση
脂肪	zhī fáng	λίπος
侄子	zhí zi	ανιψιός
值班	zhí bān	στο καθήκον
执行	zhí xíng	διεξήχθη
执着	zhí zhuó	επιμονή
殖民地	zhí mín dì	αποικία
直播	zhí bō	ζωντανή μετάδοση
直径	zhí jìng	διάμετρος
职能	zhí néng	λειτουργία
职位	zhí wèi	θέση
职务	zhí wù	θέση
指标	zhǐ biāo	δείκτης
指定	zhǐ dìng	προσδιορίζω
指甲	zhǐ jia	καρφιά
指令	zhǐ lìng	εντολή
指南针	zhǐ nán zhēn	πυξίδα
指示	zhǐ shì	οδηγίες
指望	zhǐ wàng	βασίζομαι σε
指责	zhǐ zé	κατηγορώ
制裁	zhì cái	κυρώσεις
制服	zhì fú	στολή
制约	zhì yuē	συγκράτηση
制止	zhì zhǐ	να σταματήσει
志气	zhì qì	φιλοδοξία
智力	zhì lì	νοημοσύνη
智能	zhì néng	έξυπνος
智商	zhì shāng	iq
治安	zhì ān	νόμος και τάξη
治理	zhì lǐ	διακυβέρνηση
滞留	zhì liú	διαμονή
致辞	zhì cí	διεύθυνση
致力	zhì lì	αφοσιωμένος σε
致使	zhì shǐ	αιτία
中断	zhōng duàn	διακοπή
中立	zhōng lì	ουδέτερος
中央	zhōng yāng	κεντρικός
忠诚	zhōng chéng	αφοσίωση
忠实	zhōng shí	πιστός
终点	zhōng diǎn	τέλος
终究	zhōng jiū	παρά όλα αυτά
终身	zhōng shēn	ισόβια
终止	zhōng zhǐ	λήξη
衷心	zhōng xīn	εγκάρδιος
种子	zhǒng zi	σπόρος
种族	zhǒng zú	αγώνας
肿瘤	zhǒng liú	ογκος
众所周知	zhòng suǒ zhōu zhī	πολύ γνωστό
种植	zhòng zhí	φύτεμα
重心	zhòng xīn	κέντρο βαρύτητας
周边	zhōu biān	περιβάλλων
周密	zhōu mì	προσεκτικός
周年	zhōu nián	επέτειος
周期	zhōu qī	κύκλος
周折	zhōu zhé	ανακύκλωση
周转	zhōu zhuǎn	τζίρος
州	zhōu	κατάσταση
粥	zhōu	χυλός
舟	zhōu	σκάφος
昼夜	zhòu yè	μέρα και νύχτα
皱纹	zhòu wén	ρυτίδα
株	zhū	ενταση
诸位	zhū wèi	ολοι
逐年	zhú nián	χρόνο με το χρόνο
主办	zhǔ bàn	πλήθος
主导	zhǔ dǎo	κύριος
主管	zhǔ guǎn	επόπτης
主流	zhǔ liú	κύρια
主权	zhǔ quán	κυριαρχία
主义	zhǔ yì	δόγμα
嘱咐	zhǔ fù	προτρέπω
拄	zhǔ	σφίξιμο
住宅	zhù zhái	κατοικητικός
助理	zhù lǐ	βοηθος διευθυντη
助手	zhù shǒu	βοηθός
注射	zhù shè	ένεση
注视	zhù shì	κυτάζω
注释	zhù shì	σχόλιο
注重	zhù zhòng	δώσε προσοχή στο
著作	zhù zuò	βιβλίο
铸造	zhù zào	χύσιμο
驻扎	zhù zhā	σταθμευμένος
拽	zhuài	σέρνω
专长	zhuān cháng	εξειδίκευση
专程	zhuān chéng	ειδικό ταξίδι
专利	zhuān lì	ευρεσιτεχνία
专题	zhuān tí	θέμα
砖	zhuān	τούβλο
转达	zhuǎn dá	μεταφέρω, εκφράζω
转让	zhuǎn ràng	μεταφορα
转移	zhuǎn yí	μεταφορα
转折	zhuǎn zhé	σημείο καμπής
传记	zhuàn jì	βιογραφία
庄稼	zhuāng jià	σπάρτα
庄严	zhuāng yán	επίσημος
庄重	zhuāng zhòng	επίσημος
装备	zhuāng bèi	εξοπλισμός
装卸	zhuāng xiè	φόρτωση και εκφόρτωση
壮观	zhuàng guān	θεαματικός
壮丽	zhuàng lì	μεγαλοπρεπής
壮烈	zhuàng liè	ηρωϊκός
幢	zhuàng	κτίριο
追悼	zhuī dào	μνημείο
追究	zhuī jiū	ερευνώ
坠	zhuì	πτώση
准则	zhǔn zé	κατευθυντήριες γραμμές
卓越	zhuó yuè	υπεροχή
琢磨	zhuó mó	ζυγίζω με το νουν
着手	zhuó shǒu	σχεδόν
着想	zhuó xiǎng	για χάρη του
着重	zhuó zhòng	επικεντρωνομαι σε
姿态	zī tài	συμπεριφορά
滋润	zī rùn	ενυδάτωση
滋味	zī wèi	γεύση
资本	zī běn	κεφάλαιο
资产	zī chǎn	περιουσιακά στοιχεία
资深	zī shēn	αρχαιότερος
资助	zī zhù	χρηματοδότηση
子弹	zǐ dàn	σφαίρα
自卑	zì bēi	κατωτερότητα
自发	zì fā	αυθόρμητος
自力更生	zì lì gēng shēng	αυτοδυναμία
自满	zì mǎn	ικανοποιημένος
自主	zì zhǔ	αυτονόμος
宗教	zōng jiào	θρησκεία
宗旨	zōng zhǐ	σκοπός
棕色	zōng sè	καφέ
踪迹	zōng jì	ίχνος
总而言之	zǒng ér yán zhī	όλα για όλα
总和	zǒng hé	άθροισμα
纵横	zòng héng	κάθετη και οριζόντια
走廊	zǒu láng	διάδρομος
走漏	zǒu lòu	διαρροή
走私	zǒu sī	λαθρεμπόριο
揍	zòu	ρυθμός
租赁	zū lìn	μίσθωση
足以	zú yǐ	επαρκής
祖父	zǔ fù	παππούς
祖国	zǔ guó	πατρίδα
祖先	zǔ xiān	πρόγονος
阻碍	zǔ ài	εμποδίζω
阻拦	zǔ lán	να σταματήσει
阻挠	zǔ náo	κωλυσιεργώ
钻研	zuān yán	εμβάθυνε
钻石	zuàn shí	διαμάντι
嘴唇	zuǐ chún	χείλια
罪犯	zuì fàn	εγκληματίας
尊严	zūn yán	αξιοπρέπεια
遵循	zūn xún	ακολουθηστε
作弊	zuò bì	απάτη
作废	zuò fèi	κενός
作风	zuò fēng	στυλ
作息	zuò xī	υπόλοιπο
做主	zuò zhǔ	καλέστε τα πλάνα
座右铭	zuò yòu míng	ρητό
