爱	ài	aimer; affectionner; être friand de; amour
八	bā	huit; 8
爸爸	bà ba	père (informel); CL: 个[ge4], 位[wei4]
杯子	bēi zi	tasse; verre; CL: 个[ge4], 支[zhi1]
北京	běi jīng	Beijing; capitale de la République populaire de Chine; Pékin
本	běn	origine; source; racine; tiges des plantes; fondation; base; classificateur pour les livres, les périodiques, les fichiers, etc; initialement
不客气	bú kè qi	Je vous en prie; de rien (réponse à quelqu'un qui remercie)
不	bù	ne pas (préfixe négatif); pas; aucun
菜	cài	plat (aliments); légumes; cuisine; CL: 盘[pan2], 道[dao4]
茶	chá	thé; feuille de thé; CL: 杯[bei1], 壶[hu2]
吃	chī	manger; avoir son repas
出租车	chū zū chē	taxi
打电话	dǎ diàn huà	téléphoner
大	dà	grand; important; large; le plus ancien; aîné
的	de	de (particule de possession ou de description)
点	diǎn	un peu; certain; goutte (de liquide); tache; repérer; grain; noter; virgule (en caractères chinois); point décimal; marque (de degré ou niveau); une place (avec certaines caractéristiques); heures; aborder brièvement; préciser; la lumière; allumer; période de temps pendant la nuit (24 minutes) (ancien); un goutte à goutte; plantoir; classificateur des petites quantités indéterminées
电脑	diàn nǎo	ordinateur; CL: 台[tai2]
电视	diàn shì	télévision; TV; CL: 台[tai2], 个[ge4]
电影	diàn yǐng	film; CL: 部[bu4], 幕[mu4], 场[chang3]
东西	dōng xi	chose; des trucs; personne (péjoratif); CL: 个[ge4], 件[jian4]
都	dōu	tous; tout; entièrement (à cause de) chacune; même; déjà
读	dú	lire; étudier; lecture de mot (par exemple la prononciation), similaire à 拼音[pin1 yin1]
对不起	duì bu qǐ	Je suis désolé; Excusez-moi; s'il vous plaît; désolé? (s'il vous plaît répéter); indigne; laisser tomber;
多	duō	beaucoup; nombreux; multi-
多少	duō shǎo	combien
儿子	ér zi	fils
二	èr	deux; 2; stupide (le dialecte de Pékin)
饭店	fàn diàn	restaurant; hôtel; CL: 家 [jia1], 個 | 个 [ge4];
飞机	fēi jī	avion; CL: 架[jia4]
分钟	fēn zhōng	minute
高兴	gāo xìng	heureux; ravi; de bonne humeur
个	gè	classificateur des personnes ou des objets en général; individu; taille
工作	gōng zuò	travail; emploi; travailler; construction; tâche; CL: 个[ge4], 份[fen4], 项[xiang4]
狗	gǒu	chien; CL: 只[zhi1], 条[tiao2]
汉语	hàn yǔ	Langue chinoise
好	hǎo	bon; bien; facilement; même; si; (suffixe indiquant la fin ou de la disponibilité)
号	hào	jour d'un mois; (suffixe utilisé après) le nom d'un navire; (ordinal) nombre
喝	hē	boire; crier (un ordre)
和	hé	et; avec; somme; union; la paix; harmonie; nom He
很	hěn	très; (adverbe de degré); tout à fait; même; terriblement
后面	hòu miàn	arrière; derrière; plus tard; après
回	huí	revenir; faire demi-tour; répondre; revenir; tourner; Groupe ethnique Hui; temps; classificateur des actes d'une pièce; section ou chapitre (d'un livre classique)
会	huì	pouvoir; être possible; volonté; assembler; rencontrer; recueillir; voir; union; groupe; association
几	jǐ	combien; plusieurs; quelques
家	jiā	maison; famille; classificateur des familles ou des entreprises; désigne les écoles philosophiques en Chine de l'ère pré-Han; nom suffixe pour les spécialistes de certaines activités telles que musicien ou révolutionnaire, correspond à -ist anglais, -er, -aire ou -ian; Jia nom; CL: 个[ge4]
叫	jiào	(s') appeler; crier; ordonner; demander; appeler; par (indique l'agent dans la mode passive)
今天	jīn tiān	aujourd'hui; l'heure actuelle
九	jiǔ	neuf; 9
开	kāi	ouvrir; commencer; allumer; conduire (un véhicule)
看	kàn	regarder
看见	kàn jiàn	voir; apercevoir
块	kuài	unité de monnaie; morceau (de terre); pièce; classificateur des morceaux de tissu, gâteau, savon; mot familier pour yuans (ou autre unité de monnaie comme le Hong Kong ou le dollar américain)
来	lái	venir; arriver; se rallier; depuis; suivant
老师	lǎo shī	professeur; CL: 个[ge4], 位[wei4]
了	le	(marqueur de l'action achevée); (particule modale intensification de l'article précédent);
冷	lěng	froid; indifférent (dans l'attitude)
里	lǐ	intérieur; doublure; interne
六	liù	six; 6
吗	ma	(point d'interrogation) Est-ce que
妈妈	mā ma	maman; mère; CL: 个[ge4], 位[wei4]
买	mǎi	acheter
猫	māo	chat; CL: 只[zhi1]
没关系	méi guān xi	ce n'est pas important (réponse à quelqu'un qui s'excuse)
没有	méi yǒu	ne pas avoir; ne pas être
米饭	mǐ fàn	riz (cuit)
名字	míng zi	nom (personne ou chose); CL: 个[ge4]
明天	míng tiān	demain
哪	nǎ	lequel? (interrogatif, suivi par un classificateur)
哪儿	nǎ er	où ?; n'importe où
那	nà	cela; ces; puis (dans ce cas); couramment pr. [nei4] devant un classificateur, particulièrement à Beijing;
呢	ne	(particule interrogative pour les sujets déjà mentionnés)
能	néng	pouvoir; être capable de; capacité; mesure; pouvoir éventuellement; (habituellement utilisé par la négative) avoir la possibilité de
你	nǐ	tu (informel); par opposition à vous, la forme soutenue 您[nin2]
年	nián	année; an; CL: 个[ge4]
女儿	nǚ ér	fille (par filiation)
朋友	péng you	ami; CL: 个[ge4], 位[wei4]
漂亮	piào liang	joli; beau
苹果	píng guǒ	pomme; CL: 个[ge4], 颗[ke1]
七	qī	sept; 7
前面	qián miàn	en avant; devant; précédent; au-dessus
钱	qián	argent (monnaie); CL: 笔[bi3]
请	qǐng	demander; inviter; s'il vous plaît (faire qqch); offrir (un repas, etc)
去	qù	aller (à); dépêcher quelqu'un; retirer; se débarrasser de; (lorsqu'il est utilisé soit avant ou après un verbe) aller dans le but de faire qc; être en dehors de l'espace ou du temps; (après un verbe de mouvement indique le mouvement loin de l'orateur); (utilisé après certains verbes, indique le détachement ou la séparation); (un temps ou un événement) vient de passer ou de s'écouler
热	rè	chaleur; chauffer; réchauffer; fervent
人	rén	personne (être humain), homme; CL: 个[ge4], 位[wei4]
认识	rèn shi	savoir; reconnaître; se familiariser avec; familiariser avec qc; connaissances; compréhension; sensibilisation; cognition
三	sān	trois; 3
商店	shāng diàn	magasin; CL: 家[jia1], 个[ge4]
上	shàng	sur
上午	shàng wǔ	matin; CL: 个[ge4]
少	shǎo	un peu; quelques-uns
谁	shéi	qui ?
什么	shén me	quoi ?; qui ?; quelque chose; rien
十	shí	dix; 10
时候	shí hou	(longueur du) temps; instant; période
是	shì	être (verbe); oui
书	shū	livre; lettre; CL: 本[ben3], 册[ce4], 部[bu4]; voir aussi Livre de l'Histoire
水	shuǐ	eau; rivière; liquide; boisson
水果	shuǐguǒ	fruit
睡觉	shuì jiào	aller au lit; aller dormir
说	shuō	parler; dire; expliquer; gronder; rapporter; une théorie (habituellement pour des termes comme 日 心 说 théorie héliocentrique);
四	sì	quatre; 4
岁	suì	classificateur des années (âge); an
他	tā	il, lui; (utilisé pour les deux sexes lorsque le sexe est inconnu ou sans importance); (devant le nom de qqn pour l'accent); l'autre
她	tā	elle (pronom)
太	tài	trop; extrêmement; le plus élevé; le plus grand
天气	tiān qì	temps (météo)
听	tīng	écouter; entendre; obéir; une boîte; classificateur pour les boissons en cannettes
同学	tóng xué	camarade de classe; CL: 位[wei4], 个[ge4]
喂	wèi	(au téléphone) allô; Hey!
我	wǒ	Je; moi; mon
我们	wǒ men	nous; nos
五	wǔ	cinq; 5
喜欢	xǐ huan	aimer bien; être friand de
下	xià	vers le bas; bas; ci-après; inférieur; plus tard; prochaine (semaine etc); deuxième (en deux parties); diminuer; descendre
下午	xià wǔ	après-midi; p.m.; CL: 个[ge4]
下雨	xià yǔ	pleuvoir; pluvieux
先生	xiān sheng	Monsieur (M.); mari; enseignant; médecin; CL: 个[ge4], 位[wei4]
现在	xiàn zài	maintenant; en ce moment; moderne; courant; aujourd'hui
想	xiǎng	penser; croire; supposer; souhaiter; vouloir; manquer
小	xiǎo	petit; minuscule; jeune
小姐	xiǎo jie	jeune femme; Mademoiselle; (argot) prostituée; CL: 个[ge4], 位[wei4]
些	xiē	certains; quelques-uns; plusieurs; (un mot de mesure)
写	xiě	écrire
谢谢	xiè xie	remercier; merci
星期	xīng qī	semaine; CL: 个[ge4]
学生	xué sheng	étudiant; écolier
学习	xué xí	apprendre; étudier
学校	xué xiào	école; CL: 所[suo3]
一	yī	un (1); unique; un (article); dès que; ensemble; ensemble; tous; tout au long
一点儿	yī diǎn er	un petit peu
医生	yī shēng	médecin; CL: 个[ge4], 位[wei4], 名[ming2]
医院	yī yuàn	hôpital; CL: 所[suo3], 家[jia1], 座[zuo4]
衣服	yī fu	vêtement; CL: 件[jian4], 套[tao4]
椅子	yǐ zi	chaise; CL: 把[ba3], 套[tao4]
有	yǒu	avoir (il y a); disposer de
月	yuè	mois; lune; CL: 个[ge4], 轮[lun2]
再见	zài jiàn	au revoir; vous revoir plus tard
在	zài	(situé) à; (être) en; exister; en train de faire qc; (indiquant une action en cours)
怎么	zěn me	comment ?; ce ?; pourquoi?
怎么样	zěn me yàng	comment est-ce?; que diriez-vous ?; comment était-ce ?; comment ça va?
这	zhè	ce; ces; (Communément pr [zhei4] devant un classificateur, surtout à Beijing..);
中国	zhōng guó	Chine; Empire du Milieu
中午	zhōng wǔ	midi; CL: 个[ge4]
住	zhù	vivre (habiter); habiter; rester à; résider
桌子	zhuō zi	table; bureau; CL: 张[zhang1], 套[tao4]
字	zì	lettre; caractère; symbole; mot; CL: 个[ge4]
昨天	zuó tiān	hier
做	zuò	faire; produire; écrire; composer; agir comme; s'engager dans; tenir (une partie); être; devenir; la fonction (dans une certaine mesure); servir; être utilisé afin de; former (un lien ou relation); faire semblant; feindre; jouer un rôle;
坐	zuò	s'asseoir; prendre un siège; prendre (un bus, avion, etc); porter des fruits
