挨	ái	يعاني
癌症	ái zhèng	سرطان
暧昧	ài mèi	غامض
爱不释手	ài bù shì shǒu	ضعه أرضا، أنزله
爱戴	ài dài	حب
安宁	ān níng	امن
安详	ān xiáng	هادئ
安置	ān zhì	تحديد مستوى
按摩	àn mó	تدليك
暗示	àn shì	ملحوظة
案件	àn jiàn	قضية
案例	àn lì	قضية
昂贵	áng guì	مكلفة
凹凸	āo tū	صدم
熬	áo	دمل
奥秘	ào mì	لغز
巴不得	bā bù dé	قلق
巴结	bā jie	تزلف
扒	bā	شواية
疤	bā	ندب
拔苗助长	bá miáo zhù zhǎng	اقتلاع
把关	bǎ guān	التحقق من
把手	bǎ shǒu	مقبض
罢工	bà gōng	إضراب
霸道	bà dào	متعجرف
掰	bāi	وداعا
摆脱	bǎi tuō	تخلص من
拜访	bài fǎng	يزور
拜年	bài nián	سنة جديدة سعيدة
拜托	bài tuō	رجاء
败坏	bài huài	فاسد
斑	bān	بقعة
颁布	bān bù	نشر
颁发	bān fā	القضية
版本	bǎn běn	الإصدار
伴侣	bàn lv3	رفيق
伴随	bàn suí	مصاحب
半途而废	bàn tú ér fèi	تستسلم في منتصف الطريق
扮演	bàn yǎn	لعب
榜样	bǎng yàng	مثال
绑架	bǎng jià	خطف
磅	bàng	رطل
包庇	bāo bì	مأوى
包袱	bāo fu	عبء
包围	bāo wéi	محاط
包装	bāo zhuāng	صفقة
保管	bǎo guǎn	عهدة
保密	bǎo mì	يحفظ السر
保姆	bǎo mǔ	جليسه اطفال
保守	bǎo shǒu	تحفظا
保卫	bǎo wèi	الدفاع
保养	bǎo yǎng	اعمال صيانة
保障	bǎo zhàng	ضمان
保重	bǎo zhòng	اعتن بنفسك
饱和	bǎo hé	التشبع
饱经沧桑	bǎo jīng cāng sāng	تقلبات
报酬	bào chou	تعويض
报仇	bào chóu	انتقام
报答	bào dá	سداد
报复	bào fù	انتقام
报警	bào jǐng	اتصل بالشرطة
报销	bào xiāo	السداد
抱负	bào fù	طموح
暴力	bào lì	عنف
暴露	bào lù	مكشوف
曝光	bào guāng	التعرض
爆发	bào fā	انطلق
爆炸	bào zhà	انفجار
卑鄙	bēi bǐ	يعني
悲哀	bēi āi	حزن
悲惨	bēi cǎn	مأساوي
北极	běi jí	القطب الشمالي
备份	bèi fèn	دعم
备忘录	bèi wàng lù	مذكرة
背叛	bèi pàn	يخون
背诵	bèi sòng	يتلو
被动	bèi dòng	مبني للمجهول
被告	bèi gào	المدعى عليه
贝壳	bèi ké	الصدف
奔波	bēn bō	يركض حول
奔驰	bēn chí	بنز
本能	běn néng	غريزه
本钱	běn qián	رأس المال
本人	běn rén	نفسي
本身	běn shēn	بحد ذاتها
本事	běn shi	القدرة
笨拙	bèn zhuō	الخرقاء
崩溃	bēng kuì	انهيار
甭	béng	لا تفعل
蹦	bèng	قفزة
迸发	bèng fā	انفجار
逼迫	bī pò	فرض
鼻涕	bí tì	أنف
比方	bǐ fang	فمثلا
比喻	bǐ yù	تشابه مستعار
比重	bǐ zhòng	نسبة
鄙视	bǐ shì	يحتقر
弊病	bì bìng	توعك
弊端	bì duān	سلبيات
臂	bì	ذراع
闭塞	bì sè	أغلق
编织	biān zhī	نسج
边疆	biān jiāng	حدود
边界	biān jiè	الحدود
边境	biān jìng	الحدود
边缘	biān yuán	حافة
鞭策	biān cè	حافز
扁	biǎn	مسطحة
贬低	biǎn dī	استخفاف
贬义	biǎn yì	ازدراء
便利	biàn lì	مناسب
便条	biàn tiáo	ملحوظة
便于	biàn yú	سهلة ل
变故	biàn gù	مصيبة
变迁	biàn qiān	يتغيرون
变质	biàn zhì	التلف
辨认	biàn rèn	تحديد
辩护	biàn hù	الدفاع
辩解	biàn jiě	عذر
辩证	biàn zhèng	جدلية
辫子	biàn zi	جديلة
遍布	biàn bù	فوق كل
标本	biāo běn	عينة
标记	biāo jì	علامة
标题	biāo tí	عنوان
表决	biǎo jué	تصويت
表态	biǎo tài	موقف
表彰	biǎo zhāng	التعرف على
憋	biē	رجوع
别墅	bié shù	فيلا
别致	bié zhì	أناقة
别扭	biè niu	غير ملائم
濒临	bīn lín	على حافة
冰雹	bīng báo	وابل
丙	bǐng	ج
并非	bìng fēi	ليس
并列	bìng liè	جنباألى جنب
剥削	bō xuē	استغلال
拨	bō	يتصل
播种	bō zhòng	بذر
波浪	bō làng	موجة
波涛	bō tāo	أمواج
伯母	bó mǔ	عمة
博大精深	bó dà jīng shēn	واسع وعميق
博览会	bó lǎn huì	معرض
搏斗	bó dòu	يقاتل
薄弱	bó ruò	ضعيف
不顾	bú gù	بغض النظر عن
不愧	bú kuì	جدير
不料	bú liào	بشكل غير متوقع
不像话	bú xiàng huà	شائن
不屑一顾	bú xiè yī gù	رافض
哺乳	bǔ rǔ	الرضاعة الطبيعية
捕捉	bǔ zhuō	إلتقاط
补偿	bǔ cháng	ميك أب
补救	bǔ jiù	علاج
补贴	bǔ tiē	دعم مالي
不得已	bù dé yǐ	الحل الأخير
不妨	bù fáng	أيضا قد
不敢当	bù gǎn dāng	لا تجرؤ
不禁	bù jīn	لا استطيع المساعدة
不堪	bù kān	لا يطاق
不可思议	bù kě sī yì	لا يصدق
不免	bù miǎn	لا محالة
不时	bù shí	من وقت لآخر
不惜	bù xī	لا تتردد
不相上下	bù xiāng shàng xià	قابلة للمقارنة
不言而喻	bù yán ér yù	غني عن القول
不由得	bù yóu de	لا يسعه ولكن
不择手段	bù zé shǒu duàn	اللعب الصعب
不止	bù zhǐ	أكثر من
布告	bù gào	تنويه
布局	bù jú	نسق
布置	bù zhì	نسق
步伐	bù fá	سرعة
部署	bù shǔ	نشر
部位	bù wèi	موقعك
才干	cái gàn	مهارة
裁缝	cái feng	خياط
裁判	cái pàn	حكم
裁员	cái yuán	تسريح العمال
财富	cái fù	الثروة
财务	cái wù	المالية
财政	cái zhèng	الأمور المالية
彩票	cǎi piào	اليانصيب
采购	cǎi gòu	شراء
采集	cǎi jí	مجموعة
采纳	cǎi nà	تبني
参谋	cān móu	العاملين
参照	cān zhào	مرجع
残疾	cán jí	عجز
残酷	cán kù	قاسي
残留	cán liú	بقايا
残忍	cán rěn	قاسي
灿烂	càn làn	متألق
仓促	cāng cù	متسرع
仓库	cāng kù	مستودع
舱	cāng	الطائرة
苍白	cāng bái	باهت
操劳	cāo láo	اعمل بجد
操练	cāo liàn	ممارسة
操纵	cāo zòng	معالجة
操作	cāo zuò	التشغيل
嘈杂	cáo zá	مزعج
草案	cǎo àn	مشروع
草率	cǎo shuài	متسرع
侧面	cè miàn	جانب
测量	cè liáng	قياس
策划	cè huà	خطة
策略	cè lvè	إستراتيجية
层出不穷	céng chū bù qióng	بلا نهاية
层次	céng cì	مستوى
差别	chā bié	فرق
插座	chā zuò	قابس كهرباء
查获	chá huò	استولى على
刹那	chà nà	لحظة
岔	chà	فرع
诧异	chà yì	مندهش
柴油	chái yóu	زيت الديزل
搀	chān	مزج
缠绕	chán rào	لف
馋	chán	جشع
产业	chǎn yè	صناعة
阐述	chǎn shù	توضيح
颤抖	chàn dǒu	يرتجف
昌盛	chāng shèng	الازدهار
偿还	cháng huán	سداد
尝试	cháng shì	محاولة
场合	chǎng hé	مناسبات
场面	chǎng miàn	مشهد
场所	chǎng suǒ	مكان
敞开	chǎng kāi	مفتوح على مصراعيه
倡导	chàng dǎo	المؤيد
倡议	chàng yì	مبادرة
畅通	chàng tōng	الملغى حظره
畅销	chàng xiāo	الأكثر مبيعا
超越	chāo yuè	وراء
钞票	chāo piào	الأوراق النقدية
嘲笑	cháo xiào	يعيره بخطئه
巢穴	cháo xué	عش
朝代	cháo dài	سلالة حاكمة
潮流	cháo liú	الاتجاه
撤退	chè tuì	تراجع
撤销	chè xiāo	سحب او إبطال
沉淀	chén diàn	ترسب
沉闷	chén mèn	ممل
沉思	chén sī	تأمل
沉重	chén zhòng	ثقيل
沉着	chén zhuó	هدوء
陈旧	chén jiù	عفا عليها الزمن
陈列	chén liè	عرض
陈述	chén shù	بيان
称心如意	chèn xīn rú yì	مرض
衬托	chèn tuō	انطلقت
称号	chēng hào	عنوان
乘	chéng	تتضاعف
呈现	chéng xiàn	حاضر
城堡	chéng bǎo	قلعة
惩罚	chéng fá	عقاب
成本	chéng běn	كلفة
成交	chéng jiāo	صفقة
成天	chéng tiān	طوال اليوم
成效	chéng xiào	فعالية
成心	chéng xīn	عن عمد
成员	chéng yuán	عضو
承办	chéng bàn	تعهد
承包	chéng bāo	عقد
承诺	chéng nuò	ملتزم ب
橙	chéng	البرتقالي
澄清	chéng qīng	توضيح
盛	chéng	شنغ
诚挚	chéng zhì	صادق
秤	chèng	مقاييس
吃苦	chī kǔ	تعاني
吃力	chī lì	شاق
持久	chí jiǔ	دائم
迟钝	chí dùn	بطيء
迟缓	chí huǎn	بطيء
迟疑	chí yí	تردد
赤道	chì dào	استوائي
赤字	chì zì	عجز
充当	chōng dāng	يتصرف مثل
充沛	chōng pèi	الوفيرة
充实	chōng shí	يثرى
充足	chōng zú	كاف
冲动	chōng dòng	دفعة
冲击	chōng jī	صدمة
冲突	chōng tū	نزاع
崇拜	chóng bài	عبادة
崇高	chóng gāo	سامية
崇敬	chóng jìng	احترام
重叠	chóng dié	تداخل
稠密	chóu mì	كثيف
筹备	chóu bèi	تجهيز
丑恶	chǒu è	البشع
出路	chū lù	مخرج
出卖	chū mài	يبيع
出身	chū shēn	الأصل
出神	chū shén	نشوة
出息	chū xi	أمتياز
初步	chū bù	أولية
除	chú	إلا
储备	chǔ bèi	الاحتياطي
储存	chǔ cún	متجر
储蓄	chǔ xù	مدخرات
处分	chǔ fèn	عقوبة
处境	chǔ jìng	موقف
处置	chǔ zhì	تخلص من
触犯	chù fàn	الإساءة
川流不息	chuān liú bù xī	تيار مستمر
穿越	chuān yuè	اجتياز
传达	chuán dá	نقل
传单	chuán dān	فلاير
传授	chuán shòu	يعلم
船舶	chuán bó	سفينة
喘气	chuǎn qì	يلهث
串	chuàn	خيط
床单	chuáng dān	غطاء السرير
创立	chuàng lì	تأسست
创新	chuàng xīn	ابتكار
创业	chuàng yè	بدء النشاط التجاري
创作	chuàng zuò	خلق
吹牛	chuī niú	تباهى
吹捧	chuī pěng	أكثر تسطحا
炊烟	chuī yān	دخان الطبخ
垂直	chuí zhí	عمودي
锤	chuí	شاكوش
纯粹	chún cuì	بحتة
纯洁	chún jié	نقي
慈善	cí shàn	الخيرية
慈祥	cí xiáng	يرجى
磁带	cí dài	شريط
雌雄	cí xióng	ذكر و أنثى
伺候	cì hòu	تخدم
刺	cì	شوكة
次品	cì pǐn	معيب
次序	cì xù	طلب
丛	cóng	أجمة
从容	cóng róng	بهدوء
凑合	còu he	ارتجل
粗鲁	cū lǔ	قلة الادب
窜	cuàn	قناة
摧残	cuī cán	دمار
脆弱	cuì ruò	هشة
搓	cuō	إلتواء
磋商	cuō shāng	التشاور
挫折	cuò zhé	الإحباط
搭	dā	يأخذ
搭档	dā dàng	شريك
搭配	dā pèi	مباراة
答辩	dá biàn	الرد
答复	dá fù	الرد
达成	dá chéng	تصل
打包	dǎ bāo	بالة
打官司	dǎ guān si	دعوى
打击	dǎ jī	نفخ
打架	dǎ jià	يقاتل
打量	dǎ liang	ينظر الى
打猎	dǎ liè	مطاردة
打仗	dǎ zhàng	يقاتل
大不了	dà bù liǎo	صفقة كبيرة
大臣	dà chén	وزير
大伙儿	dà huǒ r	كل واحد
大肆	dà sì	عشوائيا
大体	dà tǐ	بشكل عام
大意	dà yì	الفكرة الرئيسية
大致	dà zhì	تقريبا
歹徒	dǎi tú	رجل عصابة
代价	dài jià	كلفة
代理	dài lǐ	الوكيل
带领	dài lǐng	قيادة
怠慢	dài màn	إهمال
逮捕	dài bǔ	يقبض على
担保	dān bǎo	ضمان
胆怯	dǎn qiè	خجول
淡季	dàn jì	موسمها
淡水	dàn shuǐ	مياه عذبة
蛋白质	dàn bái zhì	بروتين
诞辰	dàn chén	عيد الميلاد
诞生	dàn shēng	مولود
当场	dāng chǎng	في المنطقة
当初	dāng chū	في البداية
当代	dāng dài	معاصر
当面	dāng miàn	وجها لوجه
当前	dāng qián	تيار
当事人	dāng shì rén	حفل
当务之急	dāng wù zhī jí	صيغة الامر
当选	dāng xuǎn	انتخب
党	dǎng	حفل
档案	dàng àn	ملف
档次	dàng cì	درجة
倒闭	dǎo bì	انهيار
导弹	dǎo dàn	صاروخ
导航	dǎo háng	التنقل
导向	dǎo xiàng	يرشد
捣乱	dǎo luàn	يسبب المتاعب
盗窃	dào qiè	سرقة
稻谷	dào gǔ	حقول الأرز
得不偿失	dé bù cháng shī	لا تستحق الخسارة
得力	dé lì	فعال
得天独厚	dé tiān dú hòu	مبارك
得罪	dé zuì	الإساءة
灯笼	dēng lóng	فانوس
登录	dēng lù	تسجيل الدخول
登陆	dēng lù	تسجيل الدخول
蹬	dēng	ركلة
等候	děng hòu	انتظار
等级	děng jí	درجة
瞪	dèng	التحديق
堤坝	dī bà	سد
敌视	dí shì	عدائي
抵达	dǐ dá	وصول
抵抗	dǐ kàng	مقاومة
抵制	dǐ zhì	يقاوم
地步	dì bù	نقطة
地势	dì shì	تضاريس
地质	dì zhì	جيولوجيا
递增	dì zēng	زيادة
颠簸	diān bǒ	مطبات
颠倒	diān dǎo	يعكس
典礼	diǎn lǐ	مراسم
典型	diǎn xíng	نموذجي
点缀	diǎn zhuì	زخرفة
垫	diàn	ضمادة
奠定	diàn dìng	بسط
惦记	diàn jì	تقلق
电源	diàn yuán	مزود الطاقة
叼	diāo	استرخى
雕刻	diāo kè	النحت
雕塑	diāo sù	النحت
吊	diào	شنق
调动	diào dòng	حشد
跌	diē	خريف
丁	dīng	دينغ
叮嘱	dīng zhǔ	حض
盯	dīng	التحديق
定期	dìng qī	منتظم
定义	dìng yì	تعريف
丢人	diū rén	عار
丢三落四	diū sān là sì	تفقد كل شيء
东道主	dōng dào zhǔ	مضيف
东张西望	dōng zhāng xī wàng	ينظر حوله
董事长	dǒng shì zhǎng	رئيس
冻结	dòng jié	تجميد
动荡	dòng dàng	اضطراب
动机	dòng jī	التحفيز
动静	dòng jìng	حركة
动力	dòng lì	قوة
动脉	dòng mài	شريان
动身	dòng shēn	غادر
动手	dòng shǒu	تشابك الايدى
动态	dòng tài	ديناميكي
动员	dòng yuán	التعبئة
栋	dòng	دونغ
兜	dōu	جيب
陡峭	dǒu qiào	انحدار
斗争	dòu zhēng	صراع
督促	dū cù	حث
毒品	dú pǐn	دواء
独裁	dú cái	دكتاتورية
堵塞	dǔ sè	انسداد
赌博	dǔ bó	القمار
杜绝	dù jué	ضع نهايه ل
端	duān	النهاية
端午节	duān wǔ jié	مهرجان قوارب التنين
端正	duān zhèng	صيح
短促	duǎn cù	قصيرة
断定	duàn dìng	تحديد
断绝	duàn jué	قطع
堆积	duī jī	تراكم
兑现	duì xiàn	السيولة النقدية
对策	duì cè	إجراء مضاد
对称	duì chèn	تناظر
对付	duì fu	التعامل مع
对抗	duì kàng	مواجهة
对立	duì lì	معارضة
对联	duì lián	زوجان
对应	duì yìng	تطابق
对照	duì zhào	مراقبة
队伍	duì wu	الفريق
顿时	dùn shí	فجأة
哆嗦	duō suo	يرتجف
多元化	duō yuán huà	تنويع
堕落	duò luò	فاسد
额外	é wài	إضافي
恶心	ě xin	غثيان
恶化	è huà	تدهور
遏制	è zhì	يحتوي
恩怨	ēn yuàn	استياء
而已	ér yǐ	هذا هو
二氧化碳	èr yǎng huà tàn	نشبع
发布	fā bù	إطلاق سراح
发财	fā cái	كن غنيا
发呆	fā dāi	دوخ
发动	fā dòng	إطلاق
发觉	fā jué	تجد
发射	fā shè	انبعاث
发誓	fā shì	أقسم
发行	fā xíng	نشر
发炎	fā yán	حمى
发扬	fā yáng	المضي قدما
发育	fā yù	تطوير
法人	fǎ rén	شخص قانوني
番	fān	معجب
凡是	fán shì	الكل
繁华	fán huá	صاخبة
繁忙	fán máng	مشغول
繁体字	fán tǐ zì	الصينية التقليدية
繁殖	fán zhí	تربية
反驳	fǎn bó	دحض
反常	fǎn cháng	غير طبيعي
反感	fǎn gǎn	لم يعجبنى
反抗	fǎn kàng	تمرد
反馈	fǎn kuì	ردود الفعل
反面	fǎn miàn	سلبي
反射	fǎn shè	انعكاس
反思	fǎn sī	انعكاس
反问	fǎn wèn	سؤال بلاغي
反之	fǎn zhī	على العكس تماما
泛滥	fàn làn	فيضان
范畴	fàn chóu	الفئة
贩卖	fàn mài	يبيع
方位	fāng wèi	موضع
方言	fāng yán	لهجة
方圆	fāng yuán	فانجيوان
方针	fāng zhēn	سياسات
防守	fáng shǒu	دفاعي
防御	fáng yù	دفاع
防止	fáng zhǐ	يحول دون
防治	fáng zhì	مراقبة
纺织	fǎng zhī	الغزل والنسيج
访问	fǎng wèn	التمكن من
放大	fàng dà	تكبير
放射	fàng shè	إشعاع
非法	fēi fǎ	غير شرعي
飞禽走兽	fēi qín zǒu shòu	الطيور والوحوش
飞翔	fēi xiáng	يطير
飞跃	fēi yuè	طفرة - قفزه
肥沃	féi wò	خصب
诽谤	fěi bàng	تشهير
废除	fèi chú	إلغاء
废寝忘食	fèi qǐn wàng shí	بلا نوم
废墟	fèi xū	أثار
沸腾	fèi téng	الغليان
肺	fèi	رئة
分辨	fēn biàn	تميز
分寸	fēn cun	قياس
分红	fēn hóng	أرباح
分解	fēn jiě	انفصال
分裂	fēn liè	انشق، مزق
分泌	fēn mì	إفراز
分明	fēn míng	خامد
分歧	fēn qí	الخلاف
分散	fēn sàn	تشتت
吩咐	fēn fù	طلب
坟墓	fén mù	القبر
粉末	fěn mò	مسحوق
粉色	fěn sè	زهري
粉碎	fěn suì	تحطيم
分量	fèn liàng	جزء
愤怒	fèn nù	الغضب
丰满	fēng mǎn	ممتلئ
丰盛	fēng shèng	غني
丰收	fēng shōu	ختاتهن
封闭	fēng bì	مغلق
封建	fēng jiàn	إقطاعي
封锁	fēng suǒ	حصار
锋利	fēng lì	حاد
风暴	fēng bào	عاصفة
风度	fēng dù	سلوك
风光	fēng guāng	منظر طبيعى
风气	fēng qì	الغلاف الجوي
风趣	fēng qù	مضحك
风土人情	fēng tǔ rén qíng	العادات والتقاليد المحلية
风味	fēng wèi	نكهة
逢	féng	كل
奉献	fèng xiàn	تفان
否决	fǒu jué	حق النقض
夫妇	fū fù	زوجان
夫人	fū ren	سيدة
敷衍	fū yǎn	روتيني
俘虏	fú lǔ	أسير
幅度	fú dù	السعة
服从	fú cóng	يطيع
服气	fú qì	مقتنع
福利	fú lì	خير
福气	fú qi	بركة
符号	fú hào	رمز
辐射	fú shè	إشعاع
俯视	fǔ shì	أنظر للأسفل
抚摸	fǔ mō	التمسيد
抚养	fǔ yǎng	رفع
腐败	fǔ bài	الفساد
腐烂	fǔ làn	تعفن
腐蚀	fǔ shí	تآكل
腐朽	fǔ xiǔ	تسوس
辅助	fǔ zhù	مساعدة
副	fù	نائب
复活	fù huó	القيامة
复兴	fù xīng	إحياء
富裕	fù yù	غني
腹泻	fù xiè	إسهال
覆盖	fù gài	التغطية
负担	fù dān	عبء
赋予	fù yǔ	يعطى
附和	fù hè	امشي
附件	fù jiàn	المرفق
附属	fù shǔ	تعلق
改良	gǎi liáng	تحسن
盖章	gài zhāng	ختم
钙	gài	الكالسيوم
尴尬	gān gà	غير ملائم
干旱	gān hàn	جفاف
干扰	gān rǎo	التشوش
干涉	gān shè	يضع شخصا ما في ورطة
干预	gān yù	تدخل قضائي
感慨	gǎn kǎi	تنهد
感染	gǎn rǎn	عدوى
干劲	gàn jìn	الحماس
扛	gāng	احمل
纲领	gāng lǐng	برنامج
岗位	gǎng wèi	بريد
港口	gǎng kǒu	ميناء
港湾	gǎng wān	مرفأ
杠杆	gàng gǎn	رافعة
高超	gāo chāo	رائع
高潮	gāo cháo	ذروة
高峰	gāo fēng	قمة
高明	gāo míng	ذكي
高尚	gāo shàng	النبيل
高涨	gāo zhǎng	ارتفاع
稿件	gǎo jiàn	مخطوطة
告辞	gào cí	توديع - فراق
告诫	gào jiè	عتاب
割	gē	يقطع
搁	gē	وضع
歌颂	gē sòng	مديح
疙瘩	gē da	بثرة
鸽子	gē zi	حمامة
格局	gé jú	نمط
格式	gé shì	شكل
隔阂	gé hé	الفارق
隔离	gé lí	عزل
革命	gé mìng	ثورة
个体	gè tǐ	فرد
各抒己见	gè shū jǐ jiàn	عبر عن آرائهم
根深蒂固	gēn shēn dì gù	متأصل
根源	gēn yuán	مصدر
跟前	gēn qián	فى مواجهة
跟随	gēn suí	إتبع
跟踪	gēn zōng	المسار
更新	gēng xīn	تحديث
更正	gēng zhèng	صيح
耕地	gēng dì	أرض صالحة للزراعة
供不应求	gōng bù yìng qiú	نقص المعروض
供给	gōng jǐ	يتبرع
公安局	gōng ān jú	مكتب الأمن العام
公道	gōng dào	عدالة
公告	gōng gào	إعلان
公关	gōng guān	العلاقات العامة
公民	gōng mín	مواطن
公然	gōng rán	علنا
公认	gōng rèn	قبلت
公式	gōng shì	معادلة
公务	gōng wù	عمل رسمي
公正	gōng zhèng	مجرد
公证	gōng zhèng	التوثيق
功劳	gōng láo	ائتمان
功效	gōng xiào	تأثير
宫殿	gōng diàn	قصر
工艺品	gōng yì pǐn	الحرف
恭敬	gōng jìng	محترم
攻击	gōng jī	هجوم
攻克	gōng kè	إلتقاط
巩固	gǒng gù	توطيد
共和国	gòng hé guó	جمهورية
共计	gòng jì	مجموع
共鸣	gòng míng	صدى
勾结	gōu jié	تواطأ
钩子	gōu zi	صنارة صيد
构思	gòu sī	فكرة
姑且	gū qiě	مؤقتا
孤独	gū dú	وحيد
孤立	gū lì	معزول
辜负	gū fù	خذل
古董	gǔ dǒng	العتيقة
古怪	gǔ guài	غريبة الاطوار
股东	gǔ dōng	شريك
股份	gǔ fèn	تشارك
骨干	gǔ gàn	العمود الفقري
鼓动	gǔ dòng	أثار
固然	gù rán	بالطبع
固体	gù tǐ	صلب
固有	gù yǒu	متأصل
固执	gù zhi	عنيد
故乡	gù xiāng	الصفحة الرئيسية
故障	gù zhàng	عطل
雇佣	gù yōng	توظيف
顾虑	gù lv4	الاهتمام
顾问	gù wèn	استشاري
拐杖	guǎi zhàng	عكاز
关怀	guān huái	رعاية
关照	guān zhào	رعاية
官方	guān fāng	الرسمية
观光	guān guāng	الذهاب لمشاهدة معالم المدينة
管辖	guǎn xiá	الاختصاص القضائي
惯例	guàn lì	مؤتمر
灌溉	guàn gài	الري
罐	guàn	خزان
贯彻	guàn chè	تنفيذ
光彩	guāng cǎi	المجيد
光辉	guāng huī	المجيد
光芒	guāng máng	ضوء
光荣	guāng róng	مجد
广阔	guǎng kuò	عريض
归根到底	guī gēn dào dǐ	في التحليل النهائي
归还	guī huán	إرجاع
规范	guī fàn	تخصيص
规格	guī gé	تخصيص
规划	guī huà	التخطيط
规章	guī zhāng	اللوائح
轨道	guǐ dào	المسار
贵族	guì zú	النبيل
跪	guì	اركع
棍棒	gùn bàng	عصا
国防	guó fáng	الدفاع الوطني
国务院	guó wù yuàn	مجلس الدولة
果断	guǒ duàn	حاسم
过度	guò dù	على
过渡	guò dù	انتقال
过奖	guò jiǎng	فوق المعدل
过滤	guò lv4	منقي
过失	guò shī	خطأ
过问	guò wèn	تدخل
过瘾	guò yǐn	ممتع
过于	guò yú	جدا
嗨	hāi	مرحبا
海拔	hǎi bá	ارتفاع
海滨	hǎi bīn	شاطئ البحر
含糊	hán hu	مشاكل
含义	hán yì	المعنى
寒暄	hán xuān	تحية
罕见	hǎn jiàn	نادر
捍卫	hàn wèi	الدفاع
航空	háng kōng	طيران
航天	háng tiān	الفضاء
航行	háng xíng	إبحار
行列	háng liè	الرتب
毫米	háo mǐ	مم
毫无	háo wú	لا شيئ
豪迈	háo mài	بطولي
号召	hào zhào	يدعو إلى
耗费	hào fèi	كلفة
呵	hē	آه
合并	hé bìng	دمج
合成	hé chéng	نتيجة الجمع بين الطريحة والنقيضة
合伙	hé huǒ	شراكة
合算	hé suàn	فعاله من حيث التكلفه
和蔼	hé ǎi	طيب القلب
和解	hé jiě	تصالح
和睦	hé mù	انسجام
和气	hé qi	اللطف
和谐	hé xié	متناغم
嘿	hēi	مهلا
痕迹	hén jì	أثر
狠心	hěn xīn	بلا قلب
恨不得	hèn bu dé	لا استطيع الانتظار
哼	hēng	همف
横	héng	عرضي
哄	hōng	اقناع
烘	hōng	خبز
轰动	hōng dòng	إحساس
宏观	hóng guān	دقيق
宏伟	hóng wěi	رائع
洪水	hóng shuǐ	فيضان
喉咙	hóu lóng	حلق
吼	hǒu	هدير
候选	hòu xuǎn	مرشح
后代	hòu dài	النسل
后顾之忧	hòu gù zhī yōu	قلق
后勤	hòu qín	الخدمات اللوجستية
呼唤	hū huàn	مكالمة
呼啸	hū xiào	عواء
呼吁	hū yù	مكالمة
忽略	hū lvè	تجاهل
湖泊	hú pō	بحيرة
胡乱	hú luàn	بإهمال
胡须	hú xū	لحية
花瓣	huā bàn	البتلة
花蕾	huā lěi	برعم
华丽	huá lì	رائع
华侨	huá qiáo	الصينيون في الخارج
划分	huà fēn	يقسم
化肥	huà féi	سماد
化石	huà shí	حفرية
化验	huà yàn	فحص
化妆	huà zhuāng	ميك أب
画蛇添足	huà shé tiān zú	لا لزوم له
话筒	huà tǒng	ميكروفون
欢乐	huān lè	الفرح
环节	huán jié	حلقة الوصل
还原	huán yuán	تخفيض
缓和	huǎn hé	سهولة
患者	huàn zhě	صبور
荒凉	huāng liáng	مهجور
荒谬	huāng miù	سخيف
荒唐	huāng táng	سخيف
皇帝	huáng dì	إمبراطورية
皇后	huáng hòu	ملكة
黄昏	huáng hūn	الغسق
恍然大悟	huǎng rán dà wù	أدركت فجأة
晃	huǎng	هزة
挥霍	huī huò	تفاخر
辉煌	huī huáng	متألق
回报	huí bào	إرجاع
回避	huí bì	تجنب
回顾	huí gù	مراجعة
回收	huí shōu	إعادة التدوير
悔恨	huǐ hèn	الندم
毁灭	huǐ miè	هدم
会晤	huì wù	لقاء
汇报	huì bào	نقل
贿赂	huì lù	رشوة
昏迷	hūn mí	غيبوبة
荤	hūn	لحم
浑身	hún shēn	فوق كل
混合	hùn hé	خلط
混乱	hùn luàn	الالتباس
混淆	hùn xiáo	يربك
混浊	hùn zhuó	كثيف
活该	huó gāi	تستحقها
活力	huó lì	حيوية
火箭	huǒ jiàn	صاروخ
火焰	huǒ yàn	لهب
火药	huǒ yào	البارود
货币	huò bì	عملة
基地	jī dì	يتمركز
基金	jī jīn	الأموال
基因	jī yīn	الجين
机动	jī dòng	مناورة
机构	jī gòu	آلية
机灵	jī ling	ذكي
机密	jī mì	سري
机械	jī xiè	ميكانيكي
机遇	jī yù	فرصة
机智	jī zhì	بارع
激发	jī fā	إثارة
激励	jī lì	إثارة
激情	jī qíng	شغف
讥笑	jī xiào	سخرية
饥饿	jī è	جوع
即便	jí biàn	حتى و إن
即将	jí jiāng	قريبا
及早	jí zǎo	مبكرا
吉祥	jí xiáng	الميمون
嫉妒	jí dù	غيور
急功近利	jí gōng jìn lì	نجاح سريع
急剧	jí jù	حاد
急切	jí qiè	حريص
急于求成	jí yú qiú chéng	حريصة على النجاح
急躁	jí zào	نافذ الصبر
极端	jí duān	أقصى
极限	jí xiàn	حد
疾病	jí bìng	مرض
籍贯	jí guàn	مسقط رأس
级别	jí bié	مستوى
集团	jí tuán	مجموعة
给予	jǐ yǔ	يعطى
季军	jì jūn	المكان الثالث
季度	jì dù	ربعي
寂静	jì jìng	الصمت
寄托	jì tuō	ودع
忌讳	jì huì	المحرمات
技巧	jì qiǎo	مهارة
纪要	jì yào	ملخص
继承	jì chéng	يرث
计较	jì jiào	اهتم ب
记性	jì xing	ذاكرة
记载	jì zǎi	سجل
迹象	jì xiàng	إشارة
佳肴	jiā yáo	رقة
加工	jiā gōng	معالجة
加剧	jiā jù	تكثيف
夹杂	jiā zá	تضمين
家常	jiā cháng	عائلي
家伙	jiā huo	شاب
家属	jiā shǔ	أفراد الأسرة
家喻户晓	jiā yù hù xiǎo	معروف
坚定	jiān dìng	حازم
坚固	jiān gù	حازم
坚韧	jiān rèn	صعب
坚实	jiān shí	صلب
坚硬	jiān yìng	الصعب
尖端	jiān duān	تلميح
尖锐	jiān ruì	حاد
煎	jiān	المقلية
监督	jiān dū	الإشراف
监视	jiān shì	مراقب
监狱	jiān yù	السجن
艰难	jiān nán	صعب
剪彩	jiǎn cǎi	قص الشريط
拣	jiǎn	قطف او يقطف
检讨	jiǎn tǎo	مراجعة
检验	jiǎn yàn	اختبار
简化	jiǎn huà	تبسيط
简陋	jiǎn lòu	خام
简体字	jiǎn tǐ zì	الصينية المبسطة
简要	jiǎn yào	نبذة
健全	jiàn quán	صوت
剑	jiàn	سيف
溅	jiàn	دفقة
舰艇	jiàn tǐng	سفينة
见多识广	jiàn duō shí guǎng	واسع الاطلاع
见解	jiàn jiě	رأي
见闻	jiàn wén	المعرفه
见义勇为	jiàn yì yǒng wéi	برر
践踏	jiàn tà	يدوس
鉴别	jiàn bié	تحديد
鉴定	jiàn dìng	هوية
鉴于	jiàn yú	معطى
间谍	jiàn dié	الجاسوس
间隔	jiàn gé	فترة
间接	jiàn jiē	غير مباشر
僵硬	jiāng yìng	قاسية
将军	jiāng jūn	جنرال لواء
将近	jiāng jìn	تقريبا
将就	jiāng jiù	سوف يكون
奖励	jiǎng lì	جائزة او مكافاة
奖赏	jiǎng shǎng	جائزة او مكافاة
桨	jiǎng	مجداف
降临	jiàng lín	تأتي
交叉	jiāo chā	تعبر
交代	jiāo dài	يشرح
交涉	jiāo shè	تفاوض
交易	jiāo yì	عملية تجارية
娇气	jiāo qì	شديد الحساسية
焦点	jiāo diǎn	التركيز
焦急	jiāo jí	قلق
侥幸	jiǎo xìng	سعيد الحظ
搅拌	jiǎo bàn	يقلب
缴纳	jiǎo nà	دفع
角落	jiǎo luò	ركن
教养	jiào yǎng	تربية
较量	jiào liàng	مسابقة
接连	jiē lián	امسك
揭露	jiē lù	تعرض
皆	jiē	الكل
阶层	jiē céng	صف دراسي
截止	jié zhǐ	قطع
截至	jié zhì	اعتبارا من
杰出	jié chū	أمتياز
竭尽全力	jié jìn quán lì	ابذل قصارى جهدك
结晶	jié jīng	بلورة
结局	jié jú	النهاية
结算	jié suàn	مستوطنة
节制	jié zhì	مراقبة
节奏	jié zòu	على نفس المنوال
解除	jiě chú	رفض
解放	jiě fàng	تحرير
解雇	jiě gù	الفصل
解剖	jiě pōu	تشريح
解散	jiě sàn	حل \ سرح
解体	jiě tǐ	تفكك
借鉴	jiè jiàn	اقتراض
借助	jiè zhù	بمساعدة
戒备	jiè bèi	إنذار
界限	jiè xiàn	حد
津津有味	jīn jīn yǒu wèi	مع المذاق
金融	jīn róng	الأمور المالية
紧迫	jǐn pò	العاجلة
锦上添花	jǐn shàng tiān huā	الشربات على الكعكة
晋升	jìn shēng	ترقية وظيفية
浸泡	jìn pào	نقع
近来	jìn lái	مؤخرا
进而	jìn ér	وثم
进攻	jìn gōng	هجوم
进化	jìn huà	تطور
进展	jìn zhǎn	التقدم
兢兢业业	jīng jīng yè yè	منجز وفقا لما يمليه الضمير
惊动	jīng dòng	إزعاج
惊奇	jīng qí	مفاجأة
惊讶	jīng yà	مندهش
精打细算	jīng dǎ xì suàn	خطط بعناية
精华	jīng huá	جوهر
精简	jīng jiǎn	انسيابية
精密	jīng mì	الاحكام
精确	jīng què	دقيق
精通	jīng tōng	بارع
精心	jīng xīn	توضيح
精益求精	jīng yì qiú jīng	استمر في التحسن
精致	jīng zhì	رائع
经费	jīng fèi	التمويل
经纬	jīng wěi	خط العرض وخط الطول
茎	jīng	إيقاف
井	jǐng	حسنا
警告	jǐng gào	مذكرة قانونية
警惕	jǐng tì	إنذار
颈椎	jǐng zhuī	الفقرات العنقية
境界	jìng jiè	مملكة
敬礼	jìng lǐ	التحية
敬业	jìng yè	مخصصة
竞赛	jìng sài	منافسة
竞选	jìng xuǎn	حملة
镜头	jìng tóu	عدسة
纠纷	jiū fēn	خلاف
纠正	jiū zhèng	صيح
酒精	jiǔ jīng	كحول
就近	jiù jìn	مجاور
就业	jiù yè	توظيف
就职	jiù zhí	افتتاح
救济	jiù jì	ارتياح
居民	jū mín	سكان
居住	jū zhù	حي
拘留	jū liú	احتجاز
拘束	jū shù	ضبط النفس
鞠躬	jū gōng	ينحني
局部	jú bù	جزئي
局面	jú miàn	موقف
局势	jú shì	موقف
局限	jú xiàn	محددات
举动	jǔ dòng	نقل
举世瞩目	jǔ shì zhǔ mù	جذب انتباه العالم
举足轻重	jǔ zú qīng zhòng	محوري
咀嚼	jǔ jué	مضغ
沮丧	jǔ sàng	محبط
剧本	jù běn	النصي
剧烈	jù liè	شديدة
据悉	jù xī	يقال أن
聚精会神	jù jīng huì shén	تركيز
卷	juǎn	الصوت
倔强	jué jiàng	عنيد
决策	jué cè	اتخاذ القرار
绝望	jué wàng	اليأس
觉悟	jué wù	وعي - إدراك
觉醒	jué xǐng	الصحوة
军队	jūn duì	جيش
君子	jūn zǐ	انسان محترم
卡通	kǎ tōng	كاريكاتير
开采	kāi cǎi	التعدين
开除	kāi chú	مطرود
开阔	kāi kuò	افتح
开朗	kāi lǎng	مرح
开明	kāi míng	المستنير
开辟	kāi pì	افتح
开拓	kāi tuò	افتح
开展	kāi zhǎn	طور
开支	kāi zhī	المصروفات
刊登	kān dēng	ينشر
刊物	kān wù	النشر
勘探	kān tàn	استكشاف
侃侃而谈	kǎn kǎn ér tán	تحدث بحرية
砍伐	kǎn fá	قطع
看待	kàn dài	ينظر الى
慷慨	kāng kǎi	كريم - سخي
抗议	kàng yì	وقفة احتجاجية
考察	kǎo chá	الدراسة الاستقصائية
考古	kǎo gǔ	علم الآثار
考核	kǎo hé	تقدير
考验	kǎo yàn	اختبار
靠拢	kào lǒng	اقترب أكثر
磕	kē	طرق
科目	kē mù	موضوع
可观	kě guān	ضخم
可口	kě kǒu	طيب المذاق
可恶	kě wù	مكروه
可行	kě xíng	قابليه
渴望	kě wàng	رغبة
克制	kè zhì	ضبط النفس
刻不容缓	kè bù róng huǎn	لا وقت للتأخير
客户	kè hù	عميل
课题	kè tí	موضوع
啃	kěn	عضة
恳切	kěn qiè	صادق
坑	kēng	حفرة
空洞	kōng dòng	أجوف
空前绝后	kōng qián jué hòu	غير مسبوق
空想	kōng xiǎng	خيال
空虚	kōng xū	الفراغ
孔	kǒng	الفجوة
恐怖	kǒng bù	الرعب
恐吓	kǒng hè	تخويف
恐惧	kǒng jù	الخوف
空白	kòng bái	فارغة
空隙	kòng xì	الفارق
口气	kǒu qì	نغمة، رنه
口腔	kǒu qiāng	تجويف الفم
口头	kǒu tóu	عن طريق الفم
口音	kǒu yīn	لهجة
扣	kòu	انبعاج
哭泣	kū qì	يبكي
枯萎	kū wěi	ذابل
枯燥	kū zào	ممل
苦尽甘来	kǔ jìn gān lái	مرارة
苦涩	kǔ sè	مرارة - مر
挎	kuà	احمل
跨	kuà	امتداد
快活	kuài huo	سعيدة
宽敞	kuān chang	فسيحة
宽容	kuān róng	متسامح
款待	kuǎn dài	حسن الضيافة
款式	kuǎn shì	أسلوب
筐	kuāng	سلة
况且	kuàng qiě	الى جانب
旷课	kuàng kè	الغياب
框架	kuàng jià	الإطار
矿产	kuàng chǎn	المعدنية
亏待	kuī dài	يعامل بشكل سيئ
亏损	kuī sǔn	خسارة
捆绑	kǔn bǎng	مقيد
扩充	kuò chōng	توسيع
扩散	kuò sàn	تعريف
扩张	kuò zhāng	توسيع
啦	lā	لا
喇叭	lǎ ba	مكبر الصوت
蜡烛	là zhú	شمعة
来历	lái lì	الأصل
来源	lái yuán	مصدر
栏目	lán mù	عمود
懒惰	lǎn duò	كسول
狼狈	láng bèi	أحرجت
狼吞虎咽	láng tūn hǔ yàn	ذئب
捞	lāo	سمك
唠叨	láo dao	المزعجة
牢固	láo gù	حازم
牢骚	láo sāo	تذمر
乐趣	lè qù	بكل سرور
乐意	lè yì	راغب
雷达	léi dá	رادار
类似	lèi sì	مماثل
冷酷	lěng kù	قاسي
冷落	lěng luò	خرج
冷却	lěng què	ترطيب
愣	lèng	تجمد
黎明	lí míng	فجر
理睬	lǐ cǎi	انتبه على
理所当然	lǐ suǒ dāng rán	بالطبع بكل تأكيد
理直气壮	lǐ zhí qì zhuàng	مباشرة
理智	lǐ zhì	السبب
礼节	lǐ jié	آداب
礼尚往来	lǐ shàng wǎng lái	تبادل
里程碑	lǐ chéng bēi	معلما
例外	lì wài	استثناء
利害	lì hài	حصة
力求	lì qiú	يحاول جاهدا ل
力所能及	lì suǒ néng jí	في حدود قوتنا
力争	lì zhēng	السعي
历代	lì dài	التاريخ
历来	lì lái	دائما
立场	lì chǎng	موضع
立方	lì fāng	مكعب
立交桥	lì jiāo qiáo	ممر علوي
立体	lì tǐ	ثلاثي الأبعاد
立足	lì zú	قف
粒	lì	الحبوب
廉洁	lián jié	نظيف
联欢	lián huān	نلتقي
联络	lián luò	الإتصال
联盟	lián méng	تحالف
联想	lián xiǎng	لينوفو
连年	lián nián	سنه بعد سنه
连锁	lián suǒ	سلسلة
连同	lián tóng	معا مع
良心	liáng xīn	الضمير
晾	liàng	الهواء
谅解	liàng jiě	فهم
辽阔	liáo kuò	واسع
列举	liè jǔ	عد
临床	lín chuáng	مرضي
淋	lín	دش
吝啬	lìn sè	بخيل
伶俐	líng lì	ذكي
凌晨	líng chén	الصباح الباكر
灵感	líng gǎn	وحي - الهام
灵魂	líng hún	الروح
灵敏	líng mǐn	حساس
零星	líng xīng	متقطع
领会	lǐng huì	تفهم
领事馆	lǐng shì guǎn	قنصلية
领土	lǐng tǔ	منطقة
领悟	lǐng wù	فهم
领先	lǐng xiān	قيادة
领袖	lǐng xiù	زعيم
溜	liū	زلة
流浪	liú làng	تجول
流露	liú lù	كشف
流氓	liú máng	محتال
流通	liú tōng	الدوران
留恋	liú liàn	حنين
留念	liú niàn	تذكار
留神	liú shén	احذر
聋哑	lóng yǎ	أصم وغبي
隆重	lóng zhòng	كبير
垄断	lǒng duàn	احتكار
笼罩	lǒng zhào	يكتنفه
搂	lǒu	عناق
炉灶	lú zào	موقد
轮船	lún chuán	باخرة
轮廓	lún kuò	محيط شكل
轮胎	lún tāi	الإطارات
论坛	lùn tán	المنتدى
论证	lùn zhèng	جدال
啰唆	luō suo	مزعج
络绎不绝	luò yì bù jué	مجرى بلانهاية
落成	luò chéng	منجز
落实	luò shí	تنفيذ
屡次	lv3 cì	مرارا وتكرارا
履行	lv3 xíng	تحقيق
掠夺	lvè duó	نهب
嘛	ma	حسنا
麻痹	má bì	شلل
麻木	má mù	خدر
麻醉	má zuì	تخدير
码头	mǎ tóu	رصيف بحري
蚂蚁	mǎ yǐ	نملة
埋伏	mái fú	كمين
埋没	mái mò	مدفون
埋葬	mái zàng	دفن
脉搏	mài bó	نبض
迈	mài	خطوة
埋怨	mán yuàn	تذمر
慢性	màn xìng	مزمن
漫长	màn cháng	طويل
漫画	màn huà	كاريكاتير
蔓延	màn yán	الانتشار
忙碌	máng lù	مشغول
盲目	máng mù	عمياء
茫茫	máng máng	واسع
茫然	máng rán	في حيرة
冒充	mào chōng	انتحال الشخصية
冒犯	mào fàn	الإساءة
茂盛	mào shèng	تزدهر
媒介	méi jiè	متوسط
枚	méi	قطع
美观	měi guān	جميلة
美满	měi mǎn	سعيدة
美妙	měi miào	رائع
萌芽	méng yá	برعم
猛烈	měng liè	عنيف
眯	mī	الحول
弥补	mí bǔ	ميك أب
弥漫	mí màn	منتشر
谜语	mí yǔ	لغز
迷惑	mí huo	يربك
迷人	mí rén	ساحر
迷信	mí xìn	خرافة
密度	mì dù	كثافة
密封	mì fēng	عجل البحر
棉花	mián hua	قطن
免得	miǎn de	خشية أن
免疫	miǎn yì	حصانة
勉励	miǎn lì	التشجيع
勉强	miǎn qiǎng	بمعارضة
面貌	miàn mào	وجه
面子	miàn zi	وجه
描绘	miáo huì	تصف
瞄准	miáo zhǔn	هدف
渺小	miǎo xiǎo	صغير
藐视	miǎo shì	سخرية
灭亡	miè wáng	هلك
蔑视	miè shì	ازدراء
民间	mín jiān	قوم
民主	mín zhǔ	ديمقراطية
敏捷	mǐn jié	نشاط
敏锐	mǐn ruì	متحمس
名次	míng cì	تصنيف
名额	míng é	حصة نسبية
名副其实	míng fù qí shí	جدير بهذا الاسم
名誉	míng yù	سمعة
明明	míng míng	بوضوح
明智	míng zhì	حكيم
命名	mìng míng	اسم
摸索	mō suo	يتلمس طريقه
摩擦	mó cā	احتكاك
模范	mó fàn	نموذج
模式	mó shì	الوضع
模型	mó xíng	نموذج
磨合	mó hé	تشغيل
膜	mó	غشاء
魔鬼	mó guǐ	الشيطان
魔术	mó shù	سحر
抹杀	mǒ shā	طمس
墨水儿	mò shuǐ r	حبر
莫名其妙	mò míng qí miào	محير
默默	mò mò	بصمت
谋求	móu qiú	طلب
模样	mú yàng	مظهر خارجي
母语	mǔ yǔ	اللغة الأم
沐浴	mù yù	استحم
目睹	mù dǔ	الشاهد
目光	mù guāng	نظرة
拿手	ná shǒu	حسن
纳闷儿	nà mèn r	أتساءل
耐用	nài yòng	متين
南辕北辙	nán yuán běi zhé	متشعب
难得	nán dé	نادر
难堪	nán kān	أحرجت
难能可贵	nán néng kě guì	جدير بالثناء
恼火	nǎo huǒ	منزعج
内涵	nèi hán	دلالة
内幕	nèi mù	القصة الداخلية
内在	nèi zài	الداخلية
能量	néng liàng	الطاقة
拟定	nǐ dìng	ارسم
逆行	nì xíng	متراجع
年度	nián dù	عام
捏	niē	قرصة
凝固	níng gù	تصلب
凝聚	níng jù	تماسك
凝视	níng shì	تحديق
拧	níng	برغي
宁肯	nìng kěn	بدلا
宁愿	nìng yuàn	يفضلون
扭转	niǔ zhuǎn	إلتواء
纽扣儿	niǔ kòu r	أزرار
农历	nóng lì	تقويم قمري
浓厚	nóng hòu	قوي
奴隶	nú lì	عبد
挪	nuó	نقل
虐待	nvè dài	إساءة
哦	ò	يا
殴打	ōu dǎ	تغلب
偶像	ǒu xiàng	محبوب الجماهير
呕吐	ǒu tù	التقيؤ
趴	pā	راحه
徘徊	pái huái	تجول
排斥	pái chì	صد
排除	pái chú	استبعاد
排放	pái fàng	انبعاث
排练	pái liàn	تمرين
派别	pài bié	فصيل
派遣	pài qiǎn	إرسال
攀登	pān dēng	الصعود
盘旋	pán xuán	الدوران
判决	pàn jué	حكم
畔	pàn	مصرف
庞大	páng dà	ضخم
抛弃	pāo qì	تخلى
泡沫	pào mò	رغوة
培育	péi yù	تنشئة
配备	pèi bèi	مسلح
配偶	pèi ǒu	الزوج
配套	pèi tào	مطابقة
盆地	pén dì	حوض
烹饪	pēng rèn	طبخ
捧	pěng	معلق
劈	pī	الاختراق
批发	pī fā	بالجملة
批判	pī pàn	نقد
疲惫	pí bèi	أرهق
疲倦	pí juàn	متعبه
皮革	pí gé	جلد
屁股	pì gu	بعقب
譬如	pì rú	فمثلا
偏差	piān chā	الانحراف
偏见	piān jiàn	انحياز، نزعة
偏僻	piān pì	التحكم عن بعد
偏偏	piān piān	على العكس تماما
片断	piàn duàn	شظية
片刻	piàn kè	لحظة
漂浮	piāo fú	تطفو
飘扬	piāo yáng	رفرفة
撇	piē	قراءة سريعه
拼搏	pīn bó	عمل شاق
拼命	pīn mìng	فاقد الامل
贫乏	pín fá	فقير
贫困	pín kùn	فقير
频繁	pín fán	في كثير من الأحيان
频率	pín lv4	تكرر
品尝	pǐn cháng	المذاق
品德	pǐn dé	حرف
品质	pǐn zhì	جودة
品种	pǐn zhǒng	تشكيلة
屏幕	píng mù	شاشة
屏障	píng zhàng	حاجز
平凡	píng fán	عادي
平面	píng miàn	مسطحة
平坦	píng tǎn	مسطحة
平行	píng xíng	موازى
平庸	píng yōng	متوسط
平原	píng yuán	عادي
评估	píng gū	تقييم
评论	píng lùn	تعليق
坡	pō	ميل
泼	pō	دفقة
颇	pō	الى حد كبير
破例	pò lì	اعمل استثناء
迫不及待	pò bù jí dài	لا استطيع الانتظار
迫害	pò hài	اضطهاد
魄力	pò lì	شجاعة
扑	pū	رفرفة
铺	pū	متجر
普及	pǔ jí	عالمي
朴实	pǔ shí	بسيط
朴素	pǔ sù	بسيط
瀑布	pù bù	شلال
凄凉	qī liáng	مهجور
期望	qī wàng	توقع
期限	qī xiàn	المصطلح
欺负	qī fu	بلطجي
欺骗	qī piàn	يخدع
奇妙	qí miào	رائع
旗袍	qí páo	شيونغسام
旗帜	qí zhì	لافتة
歧视	qí shì	تمييز
齐全	qí quán	اكتمال
齐心协力	qí xīn xié lì	العمل معًا
乞丐	qǐ gài	شحاذ
企图	qǐ tú	محاولة
启程	qǐ chéng	انطلقت
启蒙	qǐ méng	تنوير
启事	qǐ shì	تنويه
启示	qǐ shì	تنوير
岂有此理	qǐ yǒu cǐ lǐ	غير منطقى
起草	qǐ cǎo	الصياغة
起初	qǐ chū	في البدايه
起伏	qǐ fú	الصعود والهبوط
起哄	qǐ hòng	صيحات الاستهجان
起码	qǐ mǎ	على الأقل
起源	qǐ yuán	الأصل
器材	qì cái	معدات
器官	qì guān	عضو
气概	qì gài	روح
气功	qì gōng	كيغونغ
气魄	qì pò	بالخط العريض
气色	qì sè	بشرة
气势	qì shì	قوة الدفع
气味	qì wèi	رائحة
气象	qì xiàng	الأرصاد الجوية
气压	qì yā	ضغط جوي
气质	qì zhí	طبع
迄今为止	qì jīn wéi zhǐ	حتى الآن
掐	qiā	قرصة
恰当	qià dàng	مناسب
恰到好处	qià dào hǎo chù	مجرد حق
恰巧	qià qiǎo	بالصدفة
洽谈	qià tán	تفاوض
千方百计	qiān fāng bǎi jì	افعل كل شيء ممكن
牵	qiān	قيادة
牵扯	qiān chě	تنطوي
牵制	qiān zhì	يحتوي
签署	qiān shǔ	إشارة
谦逊	qiān xùn	متواضع
迁就	qiān jiù	يستوعب
迁徙	qiān xǐ	الهجرة
前景	qián jǐng	احتمال
前提	qián tí	فرضية
潜力	qián lì	محتمل
潜水	qián shuǐ	الغوص
潜移默化	qián yí mò huà	بشكل غير محسوس
谴责	qiǎn zé	ادانة
抢劫	qiāng jié	سرقة
强制	qiáng zhì	إلزامي
强迫	qiǎng pò	فرض
抢救	qiǎng jiù	إنقاذ
桥梁	qiáo liáng	جسر
窍门	qiào mén	الخدعة
翘	qiào	أليس
切实	qiè shí	عملي
锲而不舍	qiè ér bù shě	عزيمة
亲密	qīn mì	أغلق
亲热	qīn rè	حنونة
侵犯	qīn fàn	ينتهك
侵略	qīn lvè	عدوان
钦佩	qīn pèi	إعجاب
勤俭	qín jiǎn	العمل الجاد
勤劳	qín láo	كادح
倾听	qīng tīng	استمع
倾向	qīng xiàng	نزعة
倾斜	qīng xié	إمالة
清澈	qīng chè	واضح
清晨	qīng chén	الصباح الباكر
清除	qīng chú	واضح
清洁	qīng jié	نظيف
清理	qīng lǐ	نظف
清晰	qīng xī	واضح
清醒	qīng xǐng	مستيقظ تماما
清真	qīng zhēn	مسلم
情报	qíng bào	الذكاء
情节	qíng jié	قطعة
情理	qíng lǐ	إحساس
情形	qíng xíng	موقف
晴朗	qíng lǎng	مشمس
请柬	qǐng jiǎn	رسالة دعوة
请教	qǐng jiào	شاور
请示	qǐng shì	اطلب التعليمات
请帖	qǐng tiě	رسالة دعوة
丘陵	qiū líng	التلال
区分	qū fēn	تميز
区域	qū yù	منطقة
屈服	qū fú	يخضع أو يستسلم
曲折	qū zhé	متعرج
驱逐	qū zhú	يطرد
渠道	qú dào	قناة
取缔	qǔ dì	المنع
曲子	qǔ zi	أغنية
趣味	qù wèi	المذاق
圈套	quān tào	فخ
全局	quán jú	عالمي
全力以赴	quán lì yǐ fù	اخرج كل شيء
拳头	quán tou	قبضة
权衡	quán héng	التنازل عن ميزة ممن أجل الحصول على أخرى
权威	quán wēi	السلطة
犬	quǎn	الكلب
缺口	quē kǒu	الفارق
缺席	quē xí	غياب
缺陷	quē xiàn	خلل
瘸	qué	عرجاء
确保	què bǎo	تأكد
确立	què lì	إنشاء
确切	què qiè	بالضبط
确信	què xìn	مقتنع
群众	qún zhòng	الجماهير
染	rǎn	صبغ
嚷	rǎng	يصيح، يصرخ، صيحة
让步	ràng bù	تنازل
饶恕	ráo shù	يغفر
扰乱	rǎo luàn	إزعاج
惹祸	rě huò	كارثة محكمة
热泪盈眶	rè lèi yíng kuàng	دموع في العيون
热门	rè mén	جمع
人道	rén dào	إنسانية
人格	rén gé	الشخصية
人工	rén gōng	مصطنع
人家	rén jia	اشخاص
人间	rén jiān	العالمية
人士	rén shì	شخص
人为	rén wéi	مصطنع
人性	rén xìng	الطبيعة البشرية
人质	rén zhì	رهينة
仁慈	rén cí	اللطف
忍耐	rěn nài	الصبر
忍受	rěn shòu	تحمل
任命	rèn mìng	موعد
任性	rèn xìng	متقلب
任意	rèn yì	اعتباطيا
任重道远	rèn zhòng dào yuǎn	وطريق طويل لنقطعه
认定	rèn dìng	تعرف
认可	rèn kě	معروف
仍旧	réng jiù	ما يزال
日新月异	rì xīn yuè yì	يتغير مع كل يوم يمر
日益	rì yì	بشكل متزايد
容貌	róng mào	مظهر خارجي
容纳	róng nà	يستوعب
容器	róng qì	حاوية
容忍	róng rěn	تحمل
溶解	róng jiě	تذوب
荣幸	róng xìng	بكل سرور
荣誉	róng yù	شرف
融化	róng huà	إنصهار
融洽	róng qià	علاقة
揉	róu	فرك
柔和	róu hé	ناعم
儒家	rú jiā	الكونفوشيوسية
弱点	ruò diǎn	ضعف
若干	ruò gān	العديد من
撒谎	sā huǎng	راحه
散文	sǎn wén	نثر
散布	sàn bù	الانتشار
散发	sàn fā	نشر
丧失	sàng shī	تخسر
骚扰	sāo rǎo	مضايقة
嫂子	sǎo zi	أخت الزوج أو اخت الزوجة
刹车	shā chē	الفرامل
啥	shá	ماذا
筛选	shāi xuǎn	منقي
山脉	shān mài	الجبال
闪烁	shǎn shuò	وامض
擅长	shàn cháng	جيد في
擅自	shàn zì	غير مصرح
伤脑筋	shāng nǎo jīn	مزعجة
商标	shāng biāo	علامة تجارية
上级	shàng jí	متفوق
上进	shàng jìn	تحفيز
上任	shàng rèn	تولى المنصب
上瘾	shàng yǐn	مدمن
上游	shàng yóu	المنبع
尚且	shàng qiě	ما يزال
捎	shāo	رافق
梢	shāo	تلميح
哨	shào	بريد
奢侈	shē chǐ	فخم. ترف
舌头	shé tou	لسان
摄氏度	shè shì dù	درجة مئوية
涉及	shè jí	متورط
社区	shè qū	تواصل اجتماعي
设立	shè lì	اقامة
设想	shè xiǎng	تخيل
设置	shè zhì	اقامة
呻吟	shēn yín	أنين
深奥	shēn ào	عميق
深沉	shēn chén	عميق
深情厚谊	shēn qíng hòu yì	صداقة عميقة
申报	shēn bào	تعلن
绅士	shēn shì	انسان محترم
神经	shén jīng	عصب
神奇	shén qí	سحري
神气	shén qì	الهواء
神圣	shén shèng	مقدس
神态	shén tài	سلوك
神仙	shén xiān	خالدة
审查	shěn chá	مراجعة
审理	shěn lǐ	محاكمة
审美	shěn měi	جمالية
审判	shěn pàn	محاكمة
慎重	shèn zhòng	حذر
渗透	shèn tòu	اختراق
声明	shēng míng	بيان
声势	shēng shì	قوة الدفع
声誉	shēng yù	سمعة
牲畜	shēng chù	الماشية
生存	shēng cún	ينجو
生机	shēng jī	حيوية
生理	shēng lǐ	فسيولوجي
生疏	shēng shū	صدئ
生态	shēng tài	علم البيئة
生物	shēng wù	بيولوجي
生效	shēng xiào	حيز التنفيذ
生肖	shēng xiào	الأبراج الفلكية
生锈	shēng xiù	الصدأ
生育	shēng yù	خصوبة
省会	shěng huì	عاصمة المقاطعة
盛产	shèng chǎn	غني
盛开	shèng kāi	إزهار
盛情	shèng qíng	حسن الضيافة
盛行	shèng xíng	تسود
胜负	shèng fù	الفوز أو الخسارة
失事	shī shì	حطام سفينة
失误	shī wù	خطأ
失踪	shī zōng	مفقود
尸体	shī tǐ	جثة
师范	shī fàn	مدرس
施加	shī jiā	فرض
施展	shī zhǎn	عرض
十足	shí zú	ممتلئ
实惠	shí huì	بأسعار معقولة، ميسور، متناول اليد
实力	shí lì	قوة
实施	shí shī	نفذ
实事求是	shí shì qiú shì	ابحث عن الحقيقة من الحقائق
实行	shí xíng	نفذ
实质	shí zhì	مستوى
拾	shí	امسك
时常	shí cháng	غالبا
时而	shí ér	بعض الأحيان
时光	shí guāng	زمن
时机	shí jī	فرصة
时事	shí shì	الاحداث الحالية
石油	shí yóu	نفط
识别	shí bié	تحديد
使命	shǐ mìng	مهمة
世代	shì dài	أجيال
事故	shì gù	حادث
事迹	shì jì	الأفعال
事件	shì jiàn	حدث
事态	shì tài	موقف
事务	shì wù	أمور
事项	shì xiàng	شيء
事业	shì yè	سبب
势必	shì bì	ملزمة
势力	shì li	قوة
是非	shì fēi	صح ام خطأ
示范	shì fàn	برهنة
示威	shì wēi	برهنة
示意	shì yì	الإشارة
视力	shì lì	رؤية
视频	shì pín	فيديو
视线	shì xiàn	مشهد
视野	shì yě	رؤية
试图	shì tú	محاولة
试验	shì yàn	اختبار
适宜	shì yí	متكافئ
逝世	shì shì	ابتعد عن الطريق
释放	shì fàng	حرر
收藏	shōu cáng	المفضلة
收缩	shōu suō	إنكمش
收益	shōu yì	الإيرادات
收音机	shōu yīn jī	مذياع
守护	shǒu hù	حارس
手法	shǒu fǎ	تقنية
手势	shǒu shì	لفتة
手艺	shǒu yì	حرفة
首饰	shǒu shì	مجوهرات
首要	shǒu yào	ابتدائي
受罪	shòu zuì	تعاني
授予	shòu yǔ	منحة
书法	shū fǎ	فن الخط
书记	shū ji	سكرتير
书籍	shū jí	الكتب
书面	shū miàn	مكتوب
疏忽	shū hu	إهمال
疏远	shū yuǎn	ينفر
舒畅	shū chàng	مريح
数额	shù é	كمية
束	shù	حزمة
束缚	shù fù	عبودية
树立	shù lì	اقامة
竖	shù	عمودي
耍	shuǎ	لعب
衰老	shuāi lǎo	شيخوخة
衰退	shuāi tuì	انخفاض
率领	shuài lǐng	قيادة
涮火锅	shuàn huǒ guō	شابو شابو
双胞胎	shuāng bāo tāi	التوأم
爽快	shuǎng kuài	بسهولة
水利	shuǐ lì	الحفاظ على المياه
水龙头	shuǐ lóng tóu	صنبور
水泥	shuǐ ní	يبني
瞬间	shùn jiān	لحظة
司法	sī fǎ	قضائي
司令	sī lìng	القائد
思念	sī niàn	يغيب
思索	sī suǒ	التفكير
思维	sī wéi	التفكير
斯文	sī wen	لطيف
私自	sī zì	سرا
死亡	sǐ wáng	الموت
四肢	sì zhī	الأطراف
寺庙	sì miào	معبد
肆无忌惮	sì wú jì dàn	عديم الضمير
饲养	sì yǎng	تربية
耸	sǒng	شاهق
艘	sōu	سفينة
苏醒	sū xǐng	استيقظ
俗话	sú huà	عامية
塑造	sù zào	شكل
素食	sù shí	طعام نباتي
素质	sù zhì	جودة
诉讼	sù sòng	دعوى
算数	suàn shù	العد
随即	suí jí	فورا
随意	suí yì	عشوائي
岁月	suì yuè	سنوات
隧道	suì dào	نفق
损坏	sǔn huài	ضرر
索取	suǒ qǔ	طلب
索性	suǒ xìng	ببساطة
塌	tā	انهيار
踏实	tā shi	ثابت
塔	tǎ	برج
台风	tái fēng	اعصار
太空	tài kōng	الفراغ
泰斗	tài dǒu	عميد
摊	tān	المماطلة
瘫痪	tān huàn	شلل
贪婪	tān lán	جشع
贪污	tān wū	الفساد
弹性	tán xìng	مرونة
坦白	tǎn bái	صريح
叹气	tàn qì	تنهد
探测	tàn cè	الكشف
探索	tàn suǒ	يكتشف
探讨	tàn tǎo	يكتشف
探望	tàn wàng	يزور
倘若	tǎng ruò	إذا
掏	tāo	حفر
滔滔不绝	tāo tāo bù jué	تحدث بلا نهاية
淘汰	táo tài	اقصاء
陶瓷	táo cí	سيراميك
陶醉	táo zuì	عربد
讨好	tǎo hǎo	رجاء
特长	tè cháng	تخصص
特定	tè dìng	محدد
特意	tè yì	خصيصا
提拔	tí bá	ترقية
提炼	tí liàn	تكرير
提示	tí shì	مستعجل
提议	tí yì	اقتراح
题材	tí cái	موضوع
体裁	tǐ cái	النوع
体积	tǐ jī	الصوت
体谅	tǐ liàng	تراعي
体面	tǐ miàn	لائق
体系	tǐ xì	النظام
天才	tiān cái	العبقري
天赋	tiān fù	موهبة
天伦之乐	tiān lún zhī lè	مرح عائلي
天然气	tiān rán qì	غاز طبيعي
天生	tiān shēng	مولود
天堂	tiān táng	الجنة
天文	tiān wén	فلكي
田径	tián jìng	تتبع وتمحص
田野	tián yě	حقل
舔	tiǎn	لعق
挑剔	tiāo ti	من الصعب إرضاءه
条款	tiáo kuǎn	شروط
条理	tiáo lǐ	منظم
条约	tiáo yuē	معاهدة
调和	tiáo hé	التصالح
调剂	tiáo jì	يعدل
调节	tiáo jié	يعدل
调解	tiáo jiě	وساطة
调料	tiáo liào	توابل
挑拨	tiǎo bō	يتنحنح
挑衅	tiǎo xìn	استفزازي
跳跃	tiào yuè	قفزة
亭子	tíng zi	جناح
停泊	tíng bó	متوقفة
停顿	tíng dùn	وقفة
停滞	tíng zhì	راكد
挺拔	tǐng bá	طويل ومستقيم
通货膨胀	tōng huò péng zhàng	التضخم
通缉	tōng jī	مطلوب
通俗	tōng sú	جمع
通讯	tōng xùn	الاتصالات
通用	tōng yòng	عالمي
同胞	tóng bāo	أخوان
同志	tóng zhì	مثلي
童话	tóng huà	حكاية خيالية
铜	tóng	النحاس
统筹兼顾	tǒng chóu jiān gù	التخطيط العام
统计	tǒng jì	الإحصاء
统统	tǒng tǒng	الكل
统治	tǒng zhì	قاعدة
投机	tóu jī	المضاربة
投票	tóu piào	تصويت
投诉	tóu sù	شكوى
投降	tóu xiáng	استسلام
投掷	tóu zhì	يرمي
透露	tòu lù	الكشف عن
秃	tū	أصلع
突破	tū pò	اختراق
图案	tú àn	نمط
徒弟	tú dì	شخص يتعلم حرفة ما
涂抹	tú mǒ	مسحة
途径	tú jìng	الطريق
土壤	tǔ rǎng	التربة
团结	tuán jié	وحدة
团体	tuán tǐ	مجموعة
团圆	tuán yuán	جمع شمل
推测	tuī cè	المضاربة
推翻	tuī fān	الإطاحة
推理	tuī lǐ	منطق
推论	tuī lùn	الإستنباط
推销	tuī xiāo	يبيع
吞吞吐吐	tūn tūn tǔ tǔ	متردد
托运	tuō yùn	شحنة
拖延	tuō yán	مماطلة
脱离	tuō lí	انفصل
妥当	tuǒ dang	مناسب
妥善	tuǒ shàn	لائق
妥协	tuǒ xié	مرونة
椭圆	tuǒ yuán	بيضاوي
唾弃	tuò qì	تخلى عن
哇	wa	رائع
挖掘	wā jué	حفر
娃娃	wá wa	دمية
瓦解	wǎ jiě	انهيار
歪曲	wāi qū	التشوه
外表	wài biǎo	مظهر خارجي
外行	wài háng	الشخص العادي
外界	wài jiè	العالم الخارجي
外向	wài xiàng	منفتح
丸	wán	حبوب منع الحمل
完备	wán bèi	اكتمال
完毕	wán bì	اكتمال
玩弄	wán nòng	لعب
玩意儿	wán yì r	شيء
顽固	wán gù	عنيد
顽强	wán qiáng	عنيد
惋惜	wǎn xī	يندم
挽回	wǎn huí	تخليص
挽救	wǎn jiù	حفظ
万分	wàn fēn	الى ابعد حد
往常	wǎng cháng	كل عادة
往事	wǎng shì	الماضي
妄想	wàng xiǎng	الوهم
危机	wēi jī	أزمة
威风	wēi fēng	هيبة
威力	wēi lì	قوة
威望	wēi wàng	هيبة
威信	wēi xìn	هيبة
微不足道	wēi bù zú dào	ضئيلة
微观	wēi guān	مجهري
为难	wéi nán	أحرجت
为期	wéi qī	المدة الزمنية
唯独	wéi dú	وحده
维持	wéi chí	الحفاظ
维护	wéi hù	الحفاظ
维生素	wéi shēng sù	فيتامينات
违背	wéi bèi	الذهاب ضد
伪造	wěi zào	تزوير
委托	wěi tuō	عمولة
委员	wěi yuán	عضو لجنة
卫星	wèi xīng	الأقمار الصناعية
喂	wèi	مرحبا (فعل)
慰问	wèi wèn	تعازي
未免	wèi miǎn	المحتوم
畏惧	wèi jù	الخوف
蔚蓝	wèi lán	أزور
温带	wēn dài	منطقة معتدلة
温和	wēn hé	خفيف
文凭	wén píng	شهادة دبلوم
文物	wén wù	الاثار الثقافية
文献	wén xiàn	الأدب
文雅	wén yǎ	أنيق
文艺	wén yì	فن
问世	wèn shì	يظهر
窝	wō	عش
乌黑	wū hēi	أسود كالفحم
污蔑	wū miè	القذف
诬陷	wū xiàn	الإطار
无比	wú bǐ	الى ابعد حد
无偿	wú cháng	مجانا
无耻	wú chǐ	وقح
无动于衷	wú dòng yú zhōng	غير مبال
无非	wú fēi	لا شيء أكثر من
无辜	wú gū	البريء
无精打采	wú jīng dǎ cǎi	فاتر
无赖	wú lài	محتال
无理取闹	wú lǐ qǔ nào	غير منطقى
无能为力	wú néng wéi lì	عاجز
无穷无尽	wú qióng wú jìn	بلا نهاية
无微不至	wú wēi bù zhì	شديد الإنتباه للتفاصيل
无忧无虑	wú yōu wú lv4	براحة البال
无知	wú zhī	جهل
侮辱	wǔ rǔ	إهانة
武器	wǔ qì	أسلحة
武侠	wǔ xiá	الفنون العسكرية
武装	wǔ zhuāng	مسلح
舞蹈	wǔ dǎo	الرقص
务必	wù bì	تأكد
物美价廉	wù měi jià lián	نوعية جيدة ورخيصة
物业	wù yè	خاصية
物资	wù zī	اللوازم
误差	wù chā	خطأ
误解	wù jiě	سوء فهم
夕阳	xī yáng	غروب الشمس
昔日	xī rì	ايام زمان
溪	xī	جدول
熄灭	xī miè	أخرج
牺牲	xī shēng	تضحية
膝盖	xī gài	الركبة
习俗	xí sú	مخصص
媳妇	xí fu	ابنة بالنسب
袭击	xí jī	الاعتداءات
喜闻乐见	xǐ wén lè jiàn	أحب أن أسمع
喜悦	xǐ yuè	الفرح
系列	xì liè	سلسلة
细菌	xì jūn	جرثومي
细胞	xì bāo	زنزانة
细致	xì zhì	شديد الإنتباه للتفاصيل
峡谷	xiá gǔ	كانيون
狭隘	xiá ài	ضيق
狭窄	xiá zhǎi	ضيق
霞	xiá	شيا
下属	xià shǔ	المرؤوس
先进	xiān jìn	المتقدمة
先前	xiān qián	سابقا
掀起	xiān qǐ	انطلقت
纤维	xiān wéi	الأساسية
鲜明	xiān míng	مشرق
嫌	xián	لم يعجبنى
嫌疑	xián yí	مشتبه فيه
弦	xián	خيط
衔接	xián jiē	الإتصال
贤惠	xián huì	فاضلة
闲话	xián huà	ثرثرة
显著	xiǎn zhù	كبير
宪法	xiàn fǎ	دستور
现场	xiàn chǎng	بالموقع
现成	xiàn chéng	جاهز
现状	xiàn zhuàng	الوضع الراهن
线索	xiàn suǒ	فكرة
陷害	xiàn hài	مؤطر
陷阱	xiàn jǐng	فخ
陷入	xiàn rù	سقط في
馅儿	xiàn r	حشوة
乡镇	xiāng zhèn	بلدة
相差	xiāng chà	فرق
相等	xiāng děng	مساو
相辅相成	xiāng fǔ xiāng chéng	يكمل كل منهما الآخر
相应	xiāng yìng	المقابلة
镶嵌	xiāng qiàn	فسيفساء
响亮	xiǎng liàng	بصوت عال
响应	xiǎng yìng	استجابة
想方设法	xiǎng fāng shè fǎ	العثور على طرق
向导	xiàng dǎo	يرشد
向来	xiàng lái	دائما
向往	xiàng wǎng	يتوقون ل
巷	xiàng	خط
相声	xiàng sheng	الحديث المتبادل
消除	xiāo chú	القضاء
消毒	xiāo dú	تطهير
消防	xiāo fáng	مكافحة الحريق
消耗	xiāo hào	تستهلك
消灭	xiāo miè	إمسح
潇洒	xiāo sǎ	أناقة
销毁	xiāo huǐ	هدم
小心翼翼	xiǎo xīn yì yì	بحذر
效益	xiào yì	فائدة
肖像	xiào xiàng	صورة
协会	xié huì	جمعية
协商	xié shāng	تفاوض
协调	xié tiáo	تنسيق
协议	xié yì	بروتوكول
协助	xié zhù	مساعدة
携带	xié dài	احمل
屑	xiè	فتات
泄露	xiè lù	افسح الطريق
泄气	xiè qì	محبط
谢绝	xiè jué	انخفاض
心得	xīn dé	تجربة
心甘情愿	xīn gān qíng yuàn	عن طيب خاطر
心灵	xīn líng	الروح
心态	xīn tài	عقلية
心疼	xīn téng	محزن
心血	xīn xuè	عمل شاق
心眼儿	xīn yǎn r	إدراكا
新陈代谢	xīn chén dài xiè	التمثيل الغذائي
新郎	xīn láng	العريس
新娘	xīn niáng	عروس
新颖	xīn yǐng	رواية
欣慰	xīn wèi	ممتن
欣欣向荣	xīn xīn xiàng róng	مزدهرة
薪水	xīn shuǐ	راتب
辛勤	xīn qín	عمل شاق
信赖	xìn lài	ثقة
信念	xìn niàn	الاعتقاد
信仰	xìn yǎng	الإيمان
信誉	xìn yù	سمعة
兴高采烈	xīng gāo cǎi liè	مبتهج
兴隆	xīng lóng	مزدهر
兴旺	xīng wàng	مزدهرة
腥	xīng	مريب
刑事	xíng shì	مجرم
形态	xíng tài	شكل
行政	xíng zhèng	إداري
兴致勃勃	xìng zhì bó bó	فرح
性感	xìng gǎn	جنسي
性命	xìng mìng	الحياة
性能	xìng néng	أداء
凶恶	xiōng è	وحشي
凶手	xiōng shǒu	قاتل
汹涌	xiōng yǒng	عنيف
胸怀	xiōng huái	عقل
胸膛	xiōng táng	صدر
雄厚	xióng hòu	قوي
雄伟	xióng wěi	مهيب
修复	xiū fù	يصلح
修建	xiū jiàn	بناء
修养	xiū yǎng	تدريب
羞耻	xiū chǐ	عار
嗅觉	xiù jué	رائحة
绣	xiù	طرز
虚假	xū jiǎ	خاطئة
虚荣	xū róng	الغرور
虚伪	xū wěi	نفاق
需求	xū qiú	الطلب
须知	xū zhī	تنويه
许可	xǔ kě	رخصة
序言	xù yán	مقدمة
畜牧	xù mù	تربية الحيوان
酗酒	xù jiǔ	إدمان الكحول
喧哗	xuān huá	ضجة
宣誓	xuān shì	يحلف اليمين
宣扬	xuān yáng	عظ
悬挂	xuán guà	ايقاف عن العمل
悬念	xuán niàn	تشويق
悬殊	xuán shū	التفاوت
悬崖峭壁	xuán yá qiào bì	انجرافات
旋律	xuán lv4	لحن
旋转	xuán zhuǎn	غزل
选拔	xuǎn bá	اختيار
选举	xuǎn jǔ	انتخاب
选手	xuǎn shǒu	لاعب
炫耀	xuàn yào	متفاخر
削	xuē	يقطع
削弱	xuē ruò	تضعف
学说	xué shuō	نظرية
学位	xué wèi	بكالوريوس العلوم
雪上加霜	xuě shàng jiā shuāng	أسوأ
血压	xuè yā	ضغط الدم
熏陶	xūn táo	edify
寻觅	xún mì	تجد
巡逻	xún luó	دورية
循环	xún huán	دورة
循序渐进	xún xù jiàn jìn	خطوة بخطوة
压迫	yā pò	القهر
压岁钱	yā suì qián	أموال العام الجديد
压缩	yā suō	ضغط
压抑	yā yì	مكتئب
压榨	yā zhà	صحافة
压制	yā zhì	كبح
鸦雀无声	yā què wú shēng	صامتة
亚军	yà jūn	المركز الثاني
淹没	yān mò	المغمورة
烟花爆竹	yān huā bào zhú	مفرقعات نارية
严峻	yán jùn	شديدة
严寒	yán hán	نزلة برد حادة
严禁	yán jìn	يمنع منعا باتا
严厉	yán lì	شديدة
严密	yán mì	ضيق
岩石	yán shí	صخرة
延期	yán qī	تمديد
延伸	yán shēn	تمديد
延续	yán xù	استمر
沿海	yán hǎi	ساحلي
炎热	yán rè	الحار
言论	yán lùn	خطاب
掩盖	yǎn gài	التغطية
掩护	yǎn hù	التغطية
掩饰	yǎn shì	التستر
演变	yǎn biàn	تطور
演习	yǎn xí	ممارسه الرياضه
演绎	yǎn yì	المستقطع
演奏	yǎn zòu	تلعب
眼光	yǎn guāng	رؤية
眼色	yǎn sè	غمزة
眼神	yǎn shén	نظرة
厌恶	yàn wù	الاشمئزاز
验收	yàn shōu	قبول
验证	yàn zhèng	التحقق
氧气	yǎng qì	الأكسجين
样品	yàng pǐn	عينة
摇摆	yáo bǎi	تأرجح
摇滚	yáo gǔn	صخرة
谣言	yáo yán	شائعة
遥控	yáo kòng	جهاز التحكم
遥远	yáo yuǎn	بعيد
耀眼	yào yǎn	مبهر
要点	yào diǎn	نقطة
要命	yào mìng	رهيب
要素	yào sù	جزء
野蛮	yě mán	وحشية
野心	yě xīn	طموح
液体	yè tǐ	سائل
一流	yī liú	الصف الأول
一如既往	yī rú jì wǎng	كما هو الحال دائما
依旧	yī jiù	ما يزال
依据	yī jù	وفقا لل
依靠	yī kào	الاعتماد
依赖	yī lài	الاعتماد
依托	yī tuō	يعتمد على
衣裳	yī shang	ملابس
一度	yí dù	مره واحده
一贯	yí guàn	ثابتة
一目了然	yí mù liǎo rán	في لمحة
一向	yí xiàng	دائما
仪器	yí qì	أداة
仪式	yí shì	مراسم
疑惑	yí huò	شك
遗产	yí chǎn	التراث
遗传	yí chuán	وراثي
遗留	yí liú	ميراث
遗失	yí shī	ضائع
以便	yǐ biàn	لهذا السبب
以免	yǐ miǎn	حتى لا
以往	yǐ wǎng	في الماضي
以至	yǐ zhì	حتى في
以致	yǐ zhì	لهذا السبب
一帆风顺	yì fān fēng shùn	سلسة
一举两得	yì jǔ liǎng dé	ضرب عصفورين بحجر واحد
一丝不苟	yì sī bù gǒu	شديد الإنتباه للتفاصيل
亦	yì	أيضا
异常	yì cháng	غير طبيعي
意料	yì liào	متوقع
意识	yì shí	الوعي
意图	yì tú	الهدف
意味着	yì wèi zhe	يعني
意向	yì xiàng	الهدف
意志	yì zhì	إرادة
毅力	yì lì	عزيمة
毅然	yì rán	بحزم
翼	yì	جناح
阴谋	yīn móu	مؤامرة
音响	yīn xiǎng	صوت
引导	yǐn dǎo	يرشد
引擎	yǐn qíng	محرك
引用	yǐn yòng	اقتبس
隐蔽	yǐn bì	مخفي
隐患	yǐn huàn	الخطر الخفي
隐瞒	yǐn mán	إخفاء
隐私	yǐn sī	خصوصية
隐约	yǐn yuē	اغمى عليه
饮食	yǐn shí	حمية
婴儿	yīng ér	طفل
英明	yīng míng	حكيم
英勇	yīng yǒng	بطولي
盈利	yíng lì	الربح
迎面	yíng miàn	ارفع فوق
应酬	yìng chou	خلق صداقات
应邀	yìng yāo	كن مدعوا
庸俗	yōng sú	مبتذلة
拥护	yōng hù	الدعم
拥有	yōng yǒu	يملك
勇于	yǒng yú	شجاع
永恒	yǒng héng	أبدي
涌现	yǒng xiàn	يظهر
踊跃	yǒng yuè	بنشاط
用户	yòng hù	المستعمل
优胜劣汰	yōu shèng liè tài	البقاء للأصلح
优先	yōu xiān	أفضلية
优异	yōu yì	ممتاز
优越	yōu yuè	متفوق
忧郁	yōu yù	كآبة
油腻	yóu nì	دهني
油漆	yóu qī	رسم
犹如	yóu rú	كما لو
有条不紊	yǒu tiáo bù wěn	المنهجي او نظامى
幼稚	yòu zhì	ساذج
诱惑	yòu huò	مع المغريات
愚蠢	yú chǔn	سخيف
愚昧	yú mèi	جهل
渔民	yú mín	الصيادين
舆论	yú lùn	الرأي العام
与日俱增	yǔ rì jù zēng	يزداد يوما بعد يوم
宇宙	yǔ zhòu	كون
羽绒服	yǔ róng fú	سترة أسفل
寓言	yù yán	حكاية
愈	yù	شفاء - يشفى
欲望	yù wàng	رغبة
熨	yù	كى الملابس
玉	yù	يشم
预料	yù liào	متوقع
预期	yù qī	متوقع
预算	yù suàn	ميزانية
预先	yù xiān	تقدم
预言	yù yán	نبوءة
预兆	yù zhào	فأل
冤枉	yuān wang	مخطئ
元首	yuán shǒu	رئيس الدولة
元素	yuán sù	جزء
元宵节	yuán xiāo jié	مهرجان الفوانيس
原告	yuán gào	مدعى
原理	yuán lǐ	المبدأ
原始	yuán shǐ	أصلي
原先	yuán xiān	أصلي
园林	yuán lín	حديقة
圆满	yuán mǎn	اكتمال
源泉	yuán quán	مصدر
缘故	yuán gù	السبب
约束	yuē shù	قيد
乐谱	yuè pǔ	الموسيقى ورقة
岳母	yuè mǔ	حماة "أم الزوج أو أم الزوجة
孕育	yùn yù	ولدت
蕴藏	yùn cáng	يحتوي
运算	yùn suàn	عملية حسابية
运行	yùn xíng	يركض
酝酿	yùn niàng	تخمير
杂技	zá jì	بهلوانية
杂交	zá jiāo	تهجين
砸	zá	تحطيم
咋	zǎ	كيف
栽培	zāi péi	زراعة
灾难	zāi nàn	كارثة
宰	zǎi	ذبح
再接再厉	zài jiē zài lì	بذل جهود دؤوبة
在意	zài yì	رعاية
攒	zǎn	حفظ
暂且	zàn qiě	في الوقت الحاضر
赞叹	zàn tàn	معجب
赞助	zàn zhù	كفيل
糟蹋	zāo tà	يفسد
遭受	zāo shòu	يعاني
遭殃	zāo yāng	تعاني
遭遇	zāo yù	يواجه .. ينجز
噪音	zào yīn	الضوضاء
造型	zào xíng	النمذجة
责怪	zé guài	لوم
贼	zéi	السارق
增添	zēng tiān	أضف
赠送	zèng sòng	يتبرع
扎	zhā	ربطة عنق
扎实	zhā shi	صلب
渣	zhā	الخبث
眨	zhǎ	رمش
诈骗	zhà piàn	تزوير
摘要	zhāi yào	ملخص
债券	zhài quàn	كفالة
沾光	zhān guāng	تراجع
瞻仰	zhān yǎng	أشيد
展示	zhǎn shì	متفاخر
展望	zhǎn wàng	الآفاق
展现	zhǎn xiàn	متفاخر
崭新	zhǎn xīn	علامة تجارية جديدة
斩钉截铁	zhǎn dīng jié tiě	بشكل حاسم
占据	zhàn jù	تشغل
占领	zhàn lǐng	احتل
战斗	zhàn dòu	قتال
战略	zhàn lvè	إستراتيجية
战术	zhàn shù	تكتيكات
战役	zhàn yì	معركة
章程	zhāng chéng	الميثاق
帐篷	zhàng peng	خيمة
障碍	zhàng ài	عقبة
招标	zhāo biāo	مزايدة
招收	zhāo shōu	تجنيد
朝气蓬勃	zhāo qì péng bó	قوي
着迷	zháo mí	مفتون
沼泽	zhǎo zé	مستنقع
照样	zhào yàng	ما يزال
照耀	zhào yào	يلمع
折腾	zhē teng	رمى
遮挡	zhē dǎng	أغلق
折	zhé	يطوى
折磨	zhé mó	معذب
侦探	zhēn tàn	المحقق
斟酌	zhēn zhuó	يعتبر
珍贵	zhēn guì	ثمين
珍稀	zhēn xī	نادر
珍珠	zhēn zhū	لؤلؤة
真理	zhēn lǐ	حقيقة
真相	zhēn xiàng	الحقيقه
真挚	zhēn zhì	صادق
枕头	zhěn tou	وسادة
振奋	zhèn fèn	رفع
振兴	zhèn xīng	تنشيط
镇定	zhèn dìng	هدوء
镇静	zhèn jìng	هدوء
阵地	zhèn dì	موضع
阵容	zhèn róng	اصطفوا
震撼	zhèn hàn	صدمة
震惊	zhèn jīng	صدمة
争端	zhēng duān	خلاف
争夺	zhēng duó	خلاف
争气	zhēng qì	يفوز
争先恐后	zhēng xiān kǒng hòu	تخليط
争议	zhēng yì	خلاف
征服	zhēng fú	يغزو
征收	zhēng shōu	مجموعة
挣扎	zhēng zhá	صراع
正月	zhēng yuè	الشهر الأول
蒸发	zhēng fā	تبخر
整顿	zhěng dùn	صحح
政策	zhèng cè	سياسات
政权	zhèng quán	النظام الحاكم
正当	zhèng dāng	مبرر
正负	zhèng fù	ايجابي وسلبي
正规	zhèng guī	منتظم
正经	zhèng jing	جدي
正气	zhèng qì	نزاهه
正义	zhèng yì	عدالة
正宗	zhèng zōng	أصيل
症状	zhèng zhuàng	علامة مرض
证实	zhèng shí	تؤكد
证书	zhèng shū	شهادة
郑重	zhèng zhòng	رسميا
之际	zhī jì	بهذه المناسبة
支撑	zhī chēng	الدعم
支出	zhī chū	المصروفات
支流	zhī liú	الرافد
支配	zhī pèi	تسيطر
支援	zhī yuán	الدعم
支柱	zhī zhù	عمود
枝	zhī	فرع شجرة
知觉	zhī jué	المعرفة
知足常乐	zhī zú cháng lè	القناعة
脂肪	zhī fáng	سمين
侄子	zhí zi	ابن أخ
值班	zhí bān	في الخدمة
执行	zhí xíng	تم تنفيذها
执着	zhí zhuó	إصرار
殖民地	zhí mín dì	مستعمرة
直播	zhí bō	بث مباشر
直径	zhí jìng	قطر الدائرة
职能	zhí néng	وظيفة
职位	zhí wèi	موضع
职务	zhí wù	موضع
指标	zhǐ biāo	فهرس
指定	zhǐ dìng	حدد
指甲	zhǐ jia	الأظافر
指令	zhǐ lìng	تعليمات
指南针	zhǐ nán zhēn	بوصلة
指示	zhǐ shì	تعليمات
指望	zhǐ wàng	اعتمد على
指责	zhǐ zé	اتهم
制裁	zhì cái	العقوبات
制服	zhì fú	زى موحد
制约	zhì yuē	ضبط النفس
制止	zhì zhǐ	قف
志气	zhì qì	طموح
智力	zhì lì	الذكاء
智能	zhì néng	ذكي
智商	zhì shāng	معدل الذكاء
治安	zhì ān	القانون والنظام
治理	zhì lǐ	الحكم
滞留	zhì liú	البقاء
致辞	zhì cí	عنوان
致力	zhì lì	ملتزم ب
致使	zhì shǐ	سبب
中断	zhōng duàn	يقطع
中立	zhōng lì	محايد
中央	zhōng yāng	وسط
忠诚	zhōng chéng	وفاء
忠实	zhōng shí	مخلص
终点	zhōng diǎn	النهاية
终究	zhōng jiū	بعد كل ذلك
终身	zhōng shēn	مدى الحياة
终止	zhōng zhǐ	نهاية
衷心	zhōng xīn	مخلص
种子	zhǒng zi	بذرة
种族	zhǒng zú	سباق
肿瘤	zhǒng liú	ورم
众所周知	zhòng suǒ zhōu zhī	معروف
种植	zhòng zhí	يزرع
重心	zhòng xīn	مركز الجاذبية
周边	zhōu biān	المحيط
周密	zhōu mì	حذر
周年	zhōu nián	ذكرى سنوية
周期	zhōu qī	دورة
周折	zhōu zhé	التف حوله
周转	zhōu zhuǎn	دوران
州	zhōu	حالة
粥	zhōu	عصيدة
舟	zhōu	قارب
昼夜	zhòu yè	ليلا و نهارا
皱纹	zhòu wén	تجعد
株	zhū	التواء
诸位	zhū wèi	كل واحد
逐年	zhú nián	عاما بعد عام
主办	zhǔ bàn	مضيف
主导	zhǔ dǎo	قيادة
主管	zhǔ guǎn	مشرف
主流	zhǔ liú	التيار
主权	zhǔ quán	سيادة
主义	zhǔ yì	عقيدة
嘱咐	zhǔ fù	حض
拄	zhǔ	يعصر
住宅	zhù zhái	سكني
助理	zhù lǐ	مساعد مدير
助手	zhù shǒu	مساعد
注射	zhù shè	حقنة
注视	zhù shì	ينظر الى
注释	zhù shì	تعليق
注重	zhù zhòng	انتبه على
著作	zhù zuò	كتاب
铸造	zhù zào	يصب
驻扎	zhù zhā	متمركز
拽	zhuài	سحب
专长	zhuān cháng	الخبرة
专程	zhuān chéng	رحلة خاصة
专利	zhuān lì	براءة الإختراع
专题	zhuān tí	موضوع
砖	zhuān	قالب طوب
转达	zhuǎn dá	نقل
转让	zhuǎn ràng	نقل
转移	zhuǎn yí	نقل
转折	zhuǎn zhé	نقطة تحول
传记	zhuàn jì	سيرة شخصية
庄稼	zhuāng jià	المحاصيل
庄严	zhuāng yán	نمطي
庄重	zhuāng zhòng	نمطي
装备	zhuāng bèi	معدات
装卸	zhuāng xiè	التحميل والتفريغ
壮观	zhuàng guān	مذهل
壮丽	zhuàng lì	رائع
壮烈	zhuàng liè	بطولي
幢	zhuàng	بناء
追悼	zhuī dào	النصب التذكاري
追究	zhuī jiū	التحقيق
坠	zhuì	خريف
准则	zhǔn zé	القواعد الارشادية
卓越	zhuó yuè	تفوق
琢磨	zhuó mó	تأمل
着手	zhuó shǒu	شرع
着想	zhuó xiǎng	من أجل خاطر
着重	zhuó zhòng	قم بالتركيز على
姿态	zī tài	موقف سلوك
滋润	zī rùn	رطب
滋味	zī wèi	المذاق
资本	zī běn	رأس المال
资产	zī chǎn	الأصول
资深	zī shēn	أول
资助	zī zhù	التمويل
子弹	zǐ dàn	رصاصة
自卑	zì bēi	الدونية
自发	zì fā	من تلقاء نفسها
自力更生	zì lì gēng shēng	الاعتماد على الذات
自满	zì mǎn	راضية
自主	zì zhǔ	واثق من نفسه
宗教	zōng jiào	دين
宗旨	zōng zhǐ	غرض
棕色	zōng sè	بنى
踪迹	zōng jì	أثر
总而言之	zǒng ér yán zhī	الكل في الكل
总和	zǒng hé	مجموع
纵横	zòng héng	الرأسي والأفقي
走廊	zǒu láng	الرواق
走漏	zǒu lòu	تسرب
走私	zǒu sī	تهريب
揍	zòu	تغلب
租赁	zū lìn	عقد الإيجار
足以	zú yǐ	كافي
祖父	zǔ fù	جد
祖国	zǔ guó	الوطن
祖先	zǔ xiān	سلف
阻碍	zǔ ài	منع
阻拦	zǔ lán	قف
阻挠	zǔ náo	عرقلة
钻研	zuān yán	الخوض في
钻石	zuàn shí	الماس
嘴唇	zuǐ chún	شفاه
罪犯	zuì fàn	مجرم
尊严	zūn yán	كرامة
遵循	zūn xún	إتبع
作弊	zuò bì	الغش
作废	zuò fèi	باطل
作风	zuò fēng	أسلوب
作息	zuò xī	راحة
做主	zuò zhǔ	الكلمة الطلقات
座右铭	zuò yòu míng	شعار
