爱情	ài qíng	حب
安排	ān pái	ترتيب
安全	ān quán	سلامة
按时	àn shí	في الوقت المحدد
按照	àn zhào	بالنسبة الى
百分之	bǎi fēn zhī	نسبه مئويه
棒	bàng	باتون
包子	bāo zi	كعكة
保护	bǎo hù	الحماية
保证	bǎo zhèng	ضمان
报名	bào míng	سجل
抱	bào	معلق
抱歉	bào qiàn	آسف
倍	bèi	مرات
本来	běn lái	في الأصل
笨	bèn	غبي
比如	bǐ rú	مثل
毕业	bì yè	تخرج
遍	biàn	فوق كل
标准	biāo zhǔn	اساسي
表格	biǎo gé	شكل
表示	biǎo shì	يعني
表演	biǎo yǎn	أداء
表扬	biǎo yáng	مديح
饼干	bǐng gān	بسكويت
并且	bìng qiě	و
博士	bó shì	دكتوراه
不过	bú guò	لكن
不得不	bù dé bù	يجب أن
不管	bù guǎn	بغض النظر عن
不仅	bù jǐn	ليس فقط
部分	bù fen	الجزء
擦	cā	فرك
猜	cāi	خمن
材料	cái liào	مواد
参观	cān guān	يزور
餐厅	cān tīng	مطعم
厕所	cè suǒ	مرحاض
差不多	chà bu duō	تقريبيا
尝	cháng	المذاق
长城	cháng chéng	حائط عظيم
长江	cháng jiāng	اليانغتسى
场	chǎng	حقل
超过	chāo guò	يتجاوز
乘坐	chéng zuò	اركب
成功	chéng gōng	نجاح
成为	chéng wéi	يصبح
诚实	chéng shí	صادق
吃惊	chī jīng	كن متفاجئا
重新	chóng xīn	إعادة
抽烟	chōu yān	يدخن
出差	chū chāi	رحلة عمل
出发	chū fā	انطلقت
出生	chū shēng	مولود
出现	chū xiàn	يظهر
厨房	chú fáng	مطبخ
传真	chuán zhēn	فاكس
窗户	chuāng hu	نافذة او شباك
词语	cí yǔ	كلمات
从来	cóng lái	أبدا
粗心	cū xīn	غير مبالي
存	cún	حفظ
错误	cuò wù	خطأ
答案	dá àn	إجابة
打扮	dǎ ban	إرتد ملابس
打扰	dǎ rǎo	إزعاج
打印	dǎ yìn	طباعة
打招呼	dǎ zhāo hu	تحية
打折	dǎ zhé	خصم
打针	dǎ zhēn	حقنة
大概	dà gài	المحتمل
大使馆	dà shǐ guǎn	السفارة
大约	dà yuē	حول
大夫	dài fu	طبيب
戴	dài	لبس
当	dāng	متى
当时	dāng shí	ثم
刀	dāo	سكين
导游	dǎo yóu	مرشد سياحي
倒	dào	معكوسة
到处	dào chù	في كل مكان
到底	dào dǐ	فى النهاية
道歉	dào qiàn	يعتذر
得	dé	get (فعل مساعد)
得意	dé yì	فخور
登机牌	dēng jī pái	بطاقة الصعود
等	děng	إلخ (جسيم)
低	dī	منخفض
底	dǐ	الأسفل
地点	dì diǎn	موقعك
地球	dì qiú	أرض
地址	dì zhǐ	عنوان
掉	diào	قطرة
调查	diào chá	الدراسة الاستقصائية
丢	diū	يرمي
动作	dòng zuò	عمل
堵车	dǔ chē	الازدحام المروري
肚子	dù zi	بطن
短信	duǎn xìn	رسالة قصيرة
对话	duì huà	حوار
对面	duì miàn	ضد
对于	duì yú	إلى عن على
儿童	ér tóng	طفل
而	ér	و
发生	fā shēng	تحدث
发展	fā zhǎn	تطور ال
法律	fǎ lv4	قانوني
翻译	fān yì	ترجمة
烦恼	fán nǎo	مضطراب
反对	fǎn duì	يعارض
方法	fāng fǎ	طريقة
方面	fāng miàn	جانب
方向	fāng xiàng	اتجاه
房东	fáng dōng	المالك
放弃	fàng qì	استسلم
放暑假	fàng shǔ jià	الاجازة الصيفية
放松	fàng sōng	الاسترخاء
份	fèn	شارك
丰富	fēng fù	غني
否则	fǒu zé	غير ذلك
符合	fú hé	يجتمع
付款	fù kuǎn	دفع
复印	fù yìn	نسخ
复杂	fù zá	مركب
富	fù	غني
父亲	fù qīn	الآب
负责	fù zé	يكون مسؤولا عن
改变	gǎi biàn	يتغيرون
干杯	gān bēi	في صحتك
感动	gǎn dòng	متحرك
感觉	gǎn jué	يشعر
感情	gǎn qíng	شعور
感谢	gǎn xiè	شكرا
敢	gǎn	جسارة
赶	gǎn	سرعه
干	gàn	جاف
刚	gāng	مجرد
高速公路	gāo sù gōng lù	الطريق السريع
胳膊	gē bo	ذراع
各	gè	كل
公里	gōng lǐ	كيلومتر
功夫	gōng fu	مجهود
工资	gōng zī	الأجر
共同	gòng tóng	مشترك
够	gòu	كافية
购物	gòu wù	التسوق
估计	gū jì	تقدير
鼓励	gǔ lì	التشجيع
故意	gù yì	عن عمد
顾客	gù kè	الزبون
挂	guà	شنق
关键	guān jiàn	الأساسي
观众	guān zhòng	الجمهور
管理	guǎn lǐ	إدارة
光	guāng	ضوء
广播	guǎng bō	بث
广告	guǎng gào	إعلان
逛	guàng	يزور
规定	guī dìng	اشترط
国籍	guó jí	البلد التي تنتمي لها
国际	guó jì	دولي
果汁	guǒ zhī	عصير فواكه
过程	guò chéng	معالجة
海洋	hǎi yáng	محيط
害羞	hài xiū	خجول
寒假	hán jià	عطلة الشتاء
汗	hàn	عرق
航班	háng bān	طيران
好处	hǎo chu	فائدة
好像	hǎo xiàng	مثل
号码	hào mǎ	رقم
合格	hé gé	تأهلت
合适	hé shì	متكافئ
盒子	hé zi	صندوق
厚	hòu	سميك
后悔	hòu huǐ	يندم
互联网	hù lián wǎng	الأنترنيت
互相	hù xiāng	بعضهم البعض
护士	hù shi	ممرضة
怀疑	huái yí	شك
回忆	huí yì	ذكريات
活动	huó dòng	نشاط
活泼	huó po	حية
火	huǒ	نار
获得	huò dé	الحصول على
基础	jī chǔ	أساس
激动	jī dòng	الإثارة
积极	jī jí	إيجابي
积累	jī lěi	تراكم
即使	jí shǐ	حتى و إن
及时	jí shí	في الوقت المناسب
寄	jì	إرسال
技术	jì shù	تقنية
既然	jì rán	منذ
继续	jì xù	الاستمرار في
计划	jì huà	خطة
记者	jì zhě	مراسل
加班	jiā bān	متأخر، بعد فوات الوقت
加油站	jiā yóu zhàn	غاز
家具	jiā jù	أثاث المنزل
假	jiǎ	خاطئة
价格	jià gé	السعر
坚持	jiān chí	الالتزام
减肥	jiǎn féi	فقدان الوزن
减少	jiǎn shǎo	أرجع للخلف - قلص
建议	jiàn yì	اقترح
将来	jiāng lái	مستقبل
奖金	jiǎng jīn	علاوة
降低	jiàng dī	خفض
降落	jiàng luò	هبوط
交	jiāo	تعبر
交流	jiāo liú	التواصل مع
交通	jiāo tōng	حركة المرور
郊区	jiāo qū	الضواحي
骄傲	jiāo ào	فخور
饺子	jiǎo zi	الزلابية
教授	jiào shòu	دكتور جامعى
教育	jiào yù	التعليم
接受	jiē shòu	قبول
接着	jiē zhe	ثم
结果	jié guǒ	نتيجة
节	jié	الجزء
节约	jié yuē	إنقاذ
解释	jiě shì	تفسير
尽管	jǐn guǎn	على الرغم من
紧张	jǐn zhāng	التوتر
禁止	jìn zhǐ	يحظر
进行	jìn xíng	اركب
京剧	jīng jù	أوبرا بكين
精彩	jīng cǎi	رائع
经济	jīng jì	الاقتصادية
经历	jīng lì	تجربة
经验	jīng yàn	تجربة
景色	jǐng sè	رأي
警察	jǐng chá	رجال الشرطة
竞争	jìng zhēng	منافسة
竟然	jìng rán	في الواقع
镜子	jìng zi	مرآة
究竟	jiū jìng	بالضبط
举	jǔ	مصعد
举办	jǔ bàn	معلق
举行	jǔ xíng	معلق
拒绝	jù jué	رفض
聚会	jù huì	نلتقي
距离	jù lí	مسافة
开玩笑	kāi wán xiào	نكتة
开心	kāi xīn	سعيدة
看法	kàn fǎ	رأي
烤鸭	kǎo yā	بط مشوي
考虑	kǎo lv4	يعتبر
棵	kē	شجرة
科学	kē xué	علم
咳嗽	ké sou	سعال
可怜	kě lián	مثير للشفقة
可是	kě shì	لكن
可惜	kě xī	للأسف
客厅	kè tīng	غرفة المعيشة
肯定	kěn dìng	بالتأكيد
空	kōng	الهواء
空气	kōng qì	الهواء
恐怕	kǒng pà	أنا خائف
苦	kǔ	مرارة - مر
矿泉水	kuàng quán shuǐ	مياه معدنية
困	kùn	نعسان
困难	kùn nan	صعب
垃圾桶	lā jī tǒng	سلة مهملات
拉	lā	سحب. شد
辣	là	الحار
来不及	lái bu jí	بعد فوات الأوان
来得及	lái de jí	بعد فوات الأوان
来自	lái zì	من عند
懒	lǎn	كسول
浪费	làng fèi	المخلفات
浪漫	làng màn	رومانسي
老虎	lǎo hǔ	نمر
冷静	lěng jìng	هدوء
理发	lǐ fà	حلاقة شعر
理解	lǐ jiě	فهم
理想	lǐ xiǎng	المثالي
礼拜天	lǐ bài tiān	الأحد
礼貌	lǐ mào	مجاملة
例如	lì rú	على سبيل المثال
力气	lì qi	قوة
厉害	lì hai	عظيم
俩	liǎ	على حد سواء
联系	lián xì	اتصل
连	lián	حتى في
凉快	liáng kuai	تهدئة
零钱	líng qián	تغير بسيط
另外	lìng wài	بالاضافة
流利	liú lì	بطلاقة
流行	liú xíng	جمع
留	liú	البقاء
旅行	lǚ xíng	السفر
乱	luàn	فوضى
律师	lv4 shī	محامي
麻烦	má fan	مشكلة
马虎	mǎ hu	غير مبالي
满	mǎn	ممتلئ
毛	máo	شعر
毛巾	máo jīn	منشفة
美丽	měi lì	جميلة
梦	mèng	حلم
迷路	mí lù	اذهب بعيدا
密码	mì mǎ	كلمه السر
免费	miǎn fèi	مجانا
秒	miǎo	ثانيا
民族	mín zú	الأمة
母亲	mǔ qīn	أم
目的	mù dì	غرض
耐心	nài xīn	صبور
难道	nán dào	فعلا
难受	nán shòu	غير مريح
内	nèi	في داخل
内容	nèi róng	المحتوى
能力	néng lì	القدرة
年龄	nián líng	عمر
弄	nòng	فعل
暖和	nuǎn huo	دافئ
偶尔	ǒu ěr	من حين اخر
排队	pái duì	طابور
排列	pái liè	ترتيب
判断	pàn duàn	حكم
陪	péi	مرافقة
批评	pī píng	نقد
皮肤	pí fū	بشرة
脾气	pí qi	لين، لطف، هدأ
篇	piān	مقالات
骗	piàn	الغش
乒乓球	pīng pāng qiú	بينج بونج
平时	píng shí	عادة
破	pò	مكسور
葡萄	pú tao	عنب
普遍	pǔ biàn	عالمي
普通话	pǔ tōng huà	الماندرين
其次	qí cì	ثانيا
其中	qí zhōng	بينهم
气候	qì hòu	مناخ
千万	qiān wàn	عشرة ملايين
签证	qiān zhèng	تأشيرة
敲	qiāo	طرق
桥	qiáo	جسر
巧克力	qiǎo kè lì	شوكولاتة
亲戚	qīn qi	نسبيا
轻	qīng	ضوء
轻松	qīng sōng	سهل
情况	qíng kuàng	يحدث
穷	qióng	فقير
区别	qū bié	الفرق
取	qǔ	يأخذ
全部	quán bù	الكل
缺点	quē diǎn	عيب
缺少	quē shǎo	نقص
却	què	لكن
确实	què shí	في الواقع
然而	rán ér	ومع ذلك
热闹	rè nao	حية
任何	rèn hé	أي
任务	rèn wu	مهمة
扔	rēng	يرمي
仍然	réng rán	ما يزال
日记	rì jì	مذكرات
入口	rù kǒu	مدخل
散步	sàn bù	يتمشى
森林	sēn lín	غابة
沙发	shā fā	كنبة
伤心	shāng xīn	حزين
商量	shāng liang	مناقشة
稍微	shāo wēi	قليل
勺子	sháo zi	ملعقة
社会	shè huì	المجتمع
深	shēn	عميق
申请	shēn qǐng	تطبيق
甚至	shèn zhì	حتى في
生活	shēng huó	الحياة
生命	shēng mìng	الحياة
生意	shēng yì	اعمال
省	shěng	المحافظة
剩	shèng	بقايا
失败	shī bài	بالفشل
失望	shī wàng	خائب الامل
师傅	shī fu	رئيس
十分	shí fēn	للغاية
实际	shí jì	فعلي
实在	shí zài	هل حقا
使	shǐ	يصنع
使用	shǐ yòng	استعمال
世纪	shì jì	مئة عام
是否	shì fǒu	سواء
适合	shì hé	مناسب ل
适应	shì yìng	تأقلم
收	shōu	تسلم
收入	shōu rù	الإيرادات
收拾	shōu shi	رزمة
首都	shǒu dū	رأس المال
首先	shǒu xiān	أولا
受不了	shòu bù liǎo	لا يمكن أن يقف
受到	shòu dào	تعاني
售货员	shòu huò yuán	مندوب مبيعات
输	shū	تخسر
熟悉	shú xī	مألوف
数量	shù liàng	كمية
数字	shù zì	رقمي
帅	shuài	وسيم
顺便	shùn biàn	على فكرة
顺利	shùn lì	بسلاسة
顺序	shùn xù	طلب
说明	shuō míng	وصف
硕士	shuò shì	ماجيستير
死	sǐ	ميت
塑料袋	sù liào dài	حقيبة بلاستيكية
速度	sù dù	سرعة
酸	suān	حامض
随便	suí biàn	عارض
随着	suí zhe	مع
孙子	sūn zi	حفيد
所有	suǒ yǒu	الكل
台	tái	محطة
抬	tái	مصعد
态度	tài du	موقف سلوك
弹钢琴	tán gāng qín	يعزف البيانو
谈	tán	حديث
汤	tāng	حساء
糖	táng	السكر
躺	tǎng	أنسدح
趟	tàng	رحلة قصيرة
讨论	tǎo lùn	مناقشة
讨厌	tǎo yàn	اكرهه
特点	tè diǎn	ميزات
提	tí	أشير
提供	tí gōng	تزود
提前	tí qián	مقدما
提醒	tí xǐng	تذكير
填空	tián kòng	املاء الفراغ
条件	tiáo jiàn	شرط
停	tíng	قف
挺	tǐng	للغاية
通过	tōng guò	بواسطة
通知	tōng zhī	تنويه
同情	tóng qíng	تعاطف، عطف
同时	tóng shí	الوقت ذاته
推	tuī	إدفع
推迟	tuī chí	تأجيل
脱	tuō	اخلع
袜子	wà zi	جورب
完全	wán quán	اكتمال
往往	wǎng wǎng	غالبا
网球	wǎng qiú	تنس
网站	wǎng zhàn	موقع الكتروني
危险	wēi xiǎn	خطر
卫生间	wèi shēng jiān	حمام
味道	wèi dào	المذاق
温度	wēn dù	درجة الحرارة
文章	wén zhāng	مقالة - سلعة
污染	wū rǎn	التلوث
无	wú	لا
无聊	wú liáo	ضجر
无论	wú lùn	بغض النظر
误会	wù huì	سوء فهم
吸引	xī yǐn	جذب
西红柿	xī hóng shì	طماطم
咸	xián	مالح
现金	xiàn jīn	السيولة النقدية
羡慕	xiàn mù	حسد
相反	xiāng fǎn	فى المقابل
相同	xiāng tóng	نفس الشيء
香	xiāng	طيب الرائحة
详细	xiáng xì	مفصلة
响	xiǎng	حلقة
橡皮	xiàng pí	ممحاة
消息	xiāo xi	أخبار
小吃	xiǎo chī	وجبة خفيفة
小伙子	xiǎo huǒ zi	الفتى
小说	xiǎo shuō	خيال
效果	xiào guǒ	تأثير
笑话	xiào huà	نكتة
心情	xīn qíng	مزاج
辛苦	xīn kǔ	الصعب
信封	xìn fēng	ظرف
信息	xìn xī	معلومات
信心	xìn xīn	الثقة
兴奋	xīng fèn	فرح
行	xíng	صف
醒	xǐng	استيقظ
幸福	xìng fú	سعيدة
性别	xìng bié	جنس
性格	xìng gé	حرف
修理	xiū lǐ	يصلح
许多	xǔ duō	كثير من
学期	xué qī	نصف السنة
呀	ya	بلى
压力	yā lì	الضغط
牙膏	yá gāo	معجون الأسنان
亚洲	yà zhōu	آسيا
严格	yán gé	صارم
严重	yán zhòng	جدي
盐	yán	ملح
研究	yán jiū	الدراسة
演出	yǎn chū	تبين
演员	yǎn yuán	الممثل
眼镜	yǎn jìng	نظارات
阳光	yáng guāng	ضوء الشمس
养成	yǎng chéng	طور
样子	yàng zi	يبدو مثل
邀请	yāo qǐng	يدعو
要是	yào shi	إذا
钥匙	yào shi	مفتاح
也许	yě xǔ	يمكن
叶子	yè zi	ورقة الشجر
页	yè	الصفحة
一切	yī qiè	الكل
以	yǐ	إلى
以为	yǐ wéi	يفكر
意见	yì jiàn	رأي
艺术	yì shù	فن
因此	yīn cǐ	وبالتالي
引起	yǐn qǐ	سبب
印象	yìn xiàng	الانطباع
赢	yíng	يفوز
应聘	yìng pìn	التقدم بطلب للحصول
勇敢	yǒng gǎn	شجاع
永远	yǒng yuǎn	دائما وإلى الأبد
优点	yōu diǎn	مميزات
优秀	yōu xiù	ممتاز
幽默	yōu mò	دعابة
尤其	yóu qí	خصوصا
由	yóu	بواسطة
由于	yóu yú	بسبب
邮局	yóu jú	مكتب البريد
友好	yǒu hǎo	ودود
友谊	yǒu yì	صداقة
有趣	yǒu qù	مثير للإعجاب
于是	yú shì	ثم
愉快	yú kuài	سعيدة
与	yǔ	مقابل
羽毛球	yǔ máo qiú	تنس الريشة
语法	yǔ fǎ	قواعد
语言	yǔ yán	لغة
预习	yù xí	معاينة
原来	yuán lái	أصلي
原谅	yuán liàng	يغفر
原因	yuán yīn	السبب
约会	yuē huì	موعد
阅读	yuè dú	اقرأ
云	yún	غيم
允许	yǔn xǔ	السماح
杂志	zá zhì	مجلة
咱们	zán men	نحن
暂时	zàn shí	مؤقتا
脏	zāng	قذر
责任	zé rèn	المسئولية
增加	zēng jiā	زيادة
占线	zhàn xiàn	مشغول
招聘	zhāo pìn	تجنيد
照	zhào	بالنسبة الى
真正	zhēn zhèng	حقيقة
整理	zhěng lǐ	فرز
正常	zhèng cháng	عادي
正好	zhèng hǎo	مجرد حق
正确	zhèng què	صيح
正式	zhèng shì	رسمي
证明	zhèng míng	إثبات
之	zhī	من
支持	zhī chí	تعليق
知识	zhī shi	المعرفه
值得	zhí de	يستحق كل هذا العناء
植物	zhí wù	نبات
直接	zhí jiē	مباشرة
职业	zhí yè	مهنة
只好	zhǐ hǎo	كان يجب ان
只要	zhǐ yào	طالما
指	zhǐ	يعني
至少	zhì shǎo	على الأقل
质量	zhì liàng	جودة
重	zhòng	وزن
重点	zhòng diǎn	التركيز
重视	zhòng shì	القيمة
周围	zhōu wéi	حول
主意	zhǔ yi	فكرة
祝贺	zhù hè	تهنئة
著名	zhù míng	مشهور
专门	zhuān mén	متخصص
专业	zhuān yè	مهنة
转	zhuǎn	منعطف أو دور
赚	zhuàn	كسب
准确	zhǔn què	دقيق
准时	zhǔn shí	في الوقت المحدد
仔细	zǐ xì	حذر
自然	zì rán	طبيعي >> صفة
自信	zì xìn	الثقة
总结	zǒng jié	لنلخص
租	zū	تأجير
最好	zuì hǎo	الأفضل
尊重	zūn zhòng	احترام
左右	zuǒ yòu	حول
作家	zuò jiā	كاتب
作用	zuò yòng	تأثير
作者	zuò zhě	مؤلف
座	zuò	مقعد
座位	zuò wèi	مقعد
