爱情	ài qíng	사랑
安排	ān pái	배열
安全	ān quán	안전
按时	àn shí	정시에
按照	àn zhào	에 따르면
百分之	bǎi fēn zhī	퍼센트
棒	bàng	지휘봉
包子	bāo zi	혈액 요소 질소
保护	bǎo hù	보호
保证	bǎo zhèng	보증
报名	bào míng	가입하기
抱	bào	보류
抱歉	bào qiàn	죄송합니다
倍	bèi	타임스
本来	běn lái	원래
笨	bèn	바보
比如	bǐ rú	같은
毕业	bì yè	눈금
遍	biàn	온통
标准	biāo zhǔn	표준
表格	biǎo gé	형태
表示	biǎo shì	방법
表演	biǎo yǎn	공연
表扬	biǎo yáng	칭찬
饼干	bǐng gān	비스킷
并且	bìng qiě	과
博士	bó shì	박사
不过	bú guò	그러나
不得不	bù dé bù	해야
不管	bù guǎn	상관없이
不仅	bù jǐn	뿐만 아니라
部分	bù fen	부분
擦	cā	장애
猜	cāi	추측
材料	cái liào	재료
参观	cān guān	방문
餐厅	cān tīng	레스토랑
厕所	cè suǒ	화장실
差不多	chà bu duō	거의
尝	cháng	맛이 나다
长城	cháng chéng	만리장성
长江	cháng jiāng	양쯔강
场	chǎng	들
超过	chāo guò	넘다
乘坐	chéng zuò	타기
成功	chéng gōng	성공
成为	chéng wéi	지다
诚实	chéng shí	정직한
吃惊	chī jīng	놀라다
重新	chóng xīn	레
抽烟	chōu yān	담배
出差	chū chāi	출장
出发	chū fā	출발하다
出生	chū shēng	태어난
出现	chū xiàn	나타나다
厨房	chú fáng	부엌
传真	chuán zhēn	팩스
窗户	chuāng hu	창문
词语	cí yǔ	말
从来	cóng lái	이제까지
粗心	cū xīn	경솔한
存	cún	저장
错误	cuò wù	오류
答案	dá àn	대답
打扮	dǎ ban	차려 입다
打扰	dǎ rǎo	방해하다
打印	dǎ yìn	인쇄
打招呼	dǎ zhāo hu	인사하다
打折	dǎ zhé	할인
打针	dǎ zhēn	주입
大概	dà gài	아마
大使馆	dà shǐ guǎn	대사관
大约	dà yuē	약
大夫	dài fu	박사님
戴	dài	입고
当	dāng	언제
当时	dāng shí	그때
刀	dāo	칼
导游	dǎo yóu	관광 가이드
倒	dào	거꾸로
到处	dào chù	어디에나
到底	dào dǐ	결국
道歉	dào qiàn	사과하다
得	dé	get (보조 동사)
得意	dé yì	교만한
登机牌	dēng jī pái	탑승권
等	děng	기타 (입자)
低	dī	낮은
底	dǐ	바닥
地点	dì diǎn	위치
地球	dì qiú	지구
地址	dì zhǐ	주소
掉	diào	하락
调查	diào chá	서베이
丢	diū	던지다
动作	dòng zuò	동작
堵车	dǔ chē	교통 체증
肚子	dù zi	배
短信	duǎn xìn	sms
对话	duì huà	대화
对面	duì miàn	반대말
对于	duì yú	...에 대한
儿童	ér tóng	아이
而	ér	과
发生	fā shēng	나오다
发展	fā zhǎn	개발
法律	fǎ lv4	적법한
翻译	fān yì	번역
烦恼	fán nǎo	당황
反对	fǎn duì	대들다
方法	fāng fǎ	방법
方面	fāng miàn	양상
方向	fāng xiàng	방향
房东	fáng dōng	주인
放弃	fàng qì	포기하다
放暑假	fàng shǔ jià	여름 휴가
放松	fàng sōng	편하게 하다
份	fèn	공유
丰富	fēng fù	풍부한
否则	fǒu zé	그렇지 않으면
符合	fú hé	만난다
付款	fù kuǎn	지불
复印	fù yìn	부
复杂	fù zá	복잡한
富	fù	풍부한
父亲	fù qīn	아버지
负责	fù zé	책임감
改变	gǎi biàn	변화
干杯	gān bēi	건배
感动	gǎn dòng	움직이는
感觉	gǎn jué	느낌
感情	gǎn qíng	감각
感谢	gǎn xiè	감사
敢	gǎn	도전
赶	gǎn	돌진
干	gàn	마른
刚	gāng	다만
高速公路	gāo sù gōng lù	고속도로
胳膊	gē bo	팔
各	gè	마다
公里	gōng lǐ	킬로미터
功夫	gōng fu	노력
工资	gōng zī	값
共同	gòng tóng	흔한
够	gòu	충분히
购物	gòu wù	쇼핑
估计	gū jì	견적
鼓励	gǔ lì	북돋우다
故意	gù yì	신중히
顾客	gù kè	고객
挂	guà	매달다
关键	guān jiàn	필수 사항
观众	guān zhòng	청중
管理	guǎn lǐ	조치
光	guāng	빛
广播	guǎng bō	방송
广告	guǎng gào	광고하는
逛	guàng	방문
规定	guī dìng	규정
国籍	guó jí	시민권 국가
国际	guó jì	국제적인
果汁	guǒ zhī	과일 주스
过程	guò chéng	방법
海洋	hǎi yáng	대양
害羞	hài xiū	수줍은
寒假	hán jià	겨울 방학
汗	hàn	땀
航班	háng bān	비행
好处	hǎo chu	이익
好像	hǎo xiàng	처럼
号码	hào mǎ	번호
合格	hé gé	자격 있는
合适	hé shì	적당한
盒子	hé zi	상자
厚	hòu	두꺼운
后悔	hòu huǐ	유감
互联网	hù lián wǎng	인터넷
互相	hù xiāng	서로
护士	hù shi	간호사
怀疑	huái yí	의심
回忆	huí yì	추억
活动	huó dòng	활동
活泼	huó po	기운찬
火	huǒ	불
获得	huò dé	얻다
基础	jī chǔ	기초
激动	jī dòng	흥분
积极	jī jí	양
积累	jī lěi	축적
即使	jí shǐ	설사
及时	jí shí	시기 적절한
寄	jì	보내다
技术	jì shù	과학 기술
既然	jì rán	이후
继续	jì xù	계속하다
计划	jì huà	계획
记者	jì zhě	보고자
加班	jiā bān	시간 외에
加油站	jiā yóu zhàn	가스
家具	jiā jù	가구
假	jiǎ	그릇된
价格	jià gé	가격
坚持	jiān chí	고수하다
减肥	jiǎn féi	살을 빼다
减少	jiǎn shǎo	줄이다
建议	jiàn yì	제안
将来	jiāng lái	미래
奖金	jiǎng jīn	보너스
降低	jiàng dī	줄이다
降落	jiàng luò	착륙
交	jiāo	가로 질러 가다
交流	jiāo liú	와 소통하다
交通	jiāo tōng	교통
郊区	jiāo qū	교외
骄傲	jiāo ào	교만한
饺子	jiǎo zi	만두
教授	jiào shòu	교수
教育	jiào yù	교육
接受	jiē shòu	동의하기
接着	jiē zhe	그때
结果	jié guǒ	결과
节	jié	부분
节约	jié yuē	절약
解释	jiě shì	설명
尽管	jǐn guǎn	에도 불구하고
紧张	jǐn zhāng	장력
禁止	jìn zhǐ	금지
进行	jìn xíng	타다
京剧	jīng jù	북경 오페라
精彩	jīng cǎi	훌륭한
经济	jīng jì	간결한
经历	jīng lì	경험
经验	jīng yàn	경험
景色	jǐng sè	전망
警察	jǐng chá	경찰
竞争	jìng zhēng	경쟁
竟然	jìng rán	사실은
镜子	jìng zi	거울
究竟	jiū jìng	바로 그거죠
举	jǔ	승강기
举办	jǔ bàn	보류
举行	jǔ xíng	보류
拒绝	jù jué	폐물
聚会	jù huì	모이다
距离	jù lí	거리
开玩笑	kāi wán xiào	농담
开心	kāi xīn	행복
看法	kàn fǎ	전망
烤鸭	kǎo yā	오리 구이
考虑	kǎo lv4	중히 여기다
棵	kē	나무
科学	kē xué	과학
咳嗽	ké sou	기침
可怜	kě lián	서투른
可是	kě shì	그러나
可惜	kě xī	운수 나쁘게
客厅	kè tīng	거실
肯定	kěn dìng	확실한
空	kōng	공기
空气	kōng qì	공기
恐怕	kǒng pà	나는 두려워
苦	kǔ	쓴
矿泉水	kuàng quán shuǐ	광천수
困	kùn	졸리는
困难	kùn nan	어려운
垃圾桶	lā jī tǒng	쓰레기통
拉	lā	손잡이
辣	là	뜨거운
来不及	lái bu jí	너무 늦었 어
来得及	lái de jí	너무 늦었 어
来自	lái zì	에서
懒	lǎn	게으른
浪费	làng fèi	낭비
浪漫	làng màn	로맨틱
老虎	lǎo hǔ	호랑이
冷静	lěng jìng	고요한
理发	lǐ fà	이발
理解	lǐ jiě	이해
理想	lǐ xiǎng	이상
礼拜天	lǐ bài tiān	일요일
礼貌	lǐ mào	예의
例如	lì rú	예 :
力气	lì qi	힘
厉害	lì hai	큰
俩	liǎ	양자 모두
联系	lián xì	접촉
连	lián	조차
凉快	liáng kuai	식혀
零钱	líng qián	작은 변화
另外	lìng wài	게다가
流利	liú lì	유창한
流行	liú xíng	인기 있는
留	liú	머무르다
旅行	lǚ xíng	여행
乱	luàn	혼돈
律师	lv4 shī	변호사
麻烦	má fan	수고
马虎	mǎ hu	경솔한
满	mǎn	완전한
毛	máo	머리
毛巾	máo jīn	수건
美丽	měi lì	아름다운
梦	mèng	꿈
迷路	mí lù	꺼져
密码	mì mǎ	암호
免费	miǎn fèi	비어 있는
秒	miǎo	둘째
民族	mín zú	민족
母亲	mǔ qīn	어머니
目的	mù dì	목적
耐心	nài xīn	환자
难道	nán dào	그것은
难受	nán shòu	앉기 불편한
内	nèi	내부
内容	nèi róng	함유량
能力	néng lì	능력
年龄	nián líng	나이
弄	nòng	하다
暖和	nuǎn huo	따뜻한
偶尔	ǒu ěr	때때로
排队	pái duì	열
排列	pái liè	배열
判断	pàn duàn	심판
陪	péi	동반하다
批评	pī píng	비판
皮肤	pí fū	피부
脾气	pí qi	기질
篇	piān	조항
骗	piàn	사기
乒乓球	pīng pāng qiú	탁구
平时	píng shí	보통
破	pò	부서진
葡萄	pú tao	포도
普遍	pǔ biàn	만능인
普通话	pǔ tōng huà	만다린 오렌지
其次	qí cì	둘째
其中	qí zhōng	그들 중
气候	qì hòu	기후
千万	qiān wàn	천만
签证	qiān zhèng	비자
敲	qiāo	노크
桥	qiáo	다리
巧克力	qiǎo kè lì	초콜릿
亲戚	qīn qi	상대적인
轻	qīng	빛
轻松	qīng sōng	쉬운
情况	qíng kuàng	사고
穷	qióng	가난한
区别	qū bié	차이점
取	qǔ	갖다
全部	quán bù	모두
缺点	quē diǎn	불리
缺少	quē shǎo	결핍
却	què	그러나
确实	què shí	과연
然而	rán ér	하나
热闹	rè nao	기운찬
任何	rèn hé	어떤
任务	rèn wu	직무
扔	rēng	던지다
仍然	réng rán	아직도
日记	rì jì	일기
入口	rù kǒu	입구
散步	sàn bù	산책하다
森林	sēn lín	숲
沙发	shā fā	소파
伤心	shāng xīn	슬퍼
商量	shāng liang	논의하다
稍微	shāo wēi	조금
勺子	sháo zi	숟가락
社会	shè huì	사회
深	shēn	깊은
申请	shēn qǐng	신청
甚至	shèn zhì	조차
生活	shēng huó	생명
生命	shēng mìng	생명
生意	shēng yì	사업
省	shěng	지방
剩	shèng	나머지
失败	shī bài	실패
失望	shī wàng	실망한
师傅	shī fu	석사
十分	shí fēn	대단히
实际	shí jì	실제
实在	shí zài	정말
使	shǐ	하다
使用	shǐ yòng	사용하다
世纪	shì jì	세기
是否	shì fǒu	인지 어떤지
适合	shì hé	적합
适应	shì yìng	개조 하다
收	shōu	받다
收入	shōu rù	수입
收拾	shōu shi	팩
首都	shǒu dū	자본
首先	shǒu xiān	가장 먼저
受不了	shòu bù liǎo	참을 수 없어
受到	shòu dào	참다
售货员	shòu huò yuán	영업 사원
输	shū	잃다
熟悉	shú xī	익숙한
数量	shù liàng	수량
数字	shù zì	디지털
帅	shuài	멋진
顺便	shùn biàn	그런데
顺利	shùn lì	부드럽게
顺序	shùn xù	주문
说明	shuō míng	기술
硕士	shuò shì	석사 학위
死	sǐ	죽은
塑料袋	sù liào dài	비닐 봉투
速度	sù dù	속도
酸	suān	산
随便	suí biàn	평상복
随着	suí zhe	와 함께
孙子	sūn zi	손자
所有	suǒ yǒu	모두
台	tái	역
抬	tái	승강기
态度	tài du	태도
弹钢琴	tán gāng qín	피아노를 치다
谈	tán	이야기
汤	tāng	수프
糖	táng	설탕
躺	tǎng	눕다
趟	tàng	여행
讨论	tǎo lùn	논의하다
讨厌	tǎo yàn	미움
特点	tè diǎn	풍모
提	tí	언급하다
提供	tí gōng	제공하다
提前	tí qián	미리
提醒	tí xǐng	상기시키다
填空	tián kòng	빈칸을 채우세요
条件	tiáo jiàn	질환
停	tíng	중지
挺	tǐng	대단히
通过	tōng guò	으로
通知	tōng zhī	주의
同情	tóng qíng	공감
同时	tóng shí	동시에
推	tuī	푸시
推迟	tuī chí	미루다
脱	tuō	이륙
袜子	wà zi	양말
完全	wán quán	완전한
往往	wǎng wǎng	자주
网球	wǎng qiú	테니스
网站	wǎng zhàn	웹 사이트
危险	wēi xiǎn	위험
卫生间	wèi shēng jiān	화장실
味道	wèi dào	맛이 나다
温度	wēn dù	온도
文章	wén zhāng	조
污染	wū rǎn	타락
无	wú	아니
无聊	wú liáo	지루한
无论	wú lùn	상관없이
误会	wù huì	오해
吸引	xī yǐn	끌다
西红柿	xī hóng shì	토마토
咸	xián	짜다
现金	xiàn jīn	현금
羡慕	xiàn mù	부러워하다
相反	xiāng fǎn	대조적으로
相同	xiāng tóng	똑같다
香	xiāng	향기로운
详细	xiáng xì	상세한
响	xiǎng	반지
橡皮	xiàng pí	탄성 고무
消息	xiāo xi	뉴스
小吃	xiǎo chī	간식
小伙子	xiǎo huǒ zi	젊은이
小说	xiǎo shuō	소설
效果	xiào guǒ	효과
笑话	xiào huà	농담
心情	xīn qíng	기분
辛苦	xīn kǔ	단단한
信封	xìn fēng	봉투
信息	xìn xī	정보
信心	xìn xīn	자신
兴奋	xīng fèn	흥분한
行	xíng	열
醒	xǐng	일어나 다
幸福	xìng fú	행복
性别	xìng bié	성별
性格	xìng gé	캐릭터
修理	xiū lǐ	수리
许多	xǔ duō	많은
学期	xué qī	학기
呀	ya	네
压力	yā lì	압력
牙膏	yá gāo	치약
亚洲	yà zhōu	아시아
严格	yán gé	엄격한
严重	yán zhòng	진지한
盐	yán	소금
研究	yán jiū	연구
演出	yǎn chū	보여 주다
演员	yǎn yuán	배우
眼镜	yǎn jìng	안경
阳光	yáng guāng	햇빛
养成	yǎng chéng	나타나게 하다
样子	yàng zi	처럼
邀请	yāo qǐng	초대
要是	yào shi	만약
钥匙	yào shi	키
也许	yě xǔ	아마도
叶子	yè zi	잎
页	yè	페이지
一切	yī qiè	모두
以	yǐ	에
以为	yǐ wéi	생각한다
意见	yì jiàn	의견
艺术	yì shù	미술
因此	yīn cǐ	따라서
引起	yǐn qǐ	원인
印象	yìn xiàng	인상
赢	yíng	승리
应聘	yìng pìn	신청
勇敢	yǒng gǎn	용감한
永远	yǒng yuǎn	영원히 그리고 항상
优点	yōu diǎn	이점
优秀	yōu xiù	우수한
幽默	yōu mò	기분
尤其	yóu qí	특히
由	yóu	으로
由于	yóu yú	때문에
邮局	yóu jú	우체국
友好	yǒu hǎo	친한
友谊	yǒu yì	우정
有趣	yǒu qù	흥미로운
于是	yú shì	그때
愉快	yú kuài	행복
与	yǔ	대
羽毛球	yǔ máo qiú	배드민턴
语法	yǔ fǎ	문법
语言	yǔ yán	언어
预习	yù xí	시사
原来	yuán lái	실물
原谅	yuán liàng	용서하다
原因	yuán yīn	이유
约会	yuē huì	약속
阅读	yuè dú	읽다
云	yún	구름
允许	yǔn xǔ	허용하다
杂志	zá zhì	매거진
咱们	zán men	우리
暂时	zàn shí	일시적으로
脏	zāng	더러운
责任	zé rèn	책임
增加	zēng jiā	증가하다
占线	zhàn xiàn	바쁜
招聘	zhāo pìn	신병 모집
照	zhào	에 따르면
真正	zhēn zhèng	레알
整理	zhěng lǐ	가리다
正常	zhèng cháng	표준
正好	zhèng hǎo	바로
正确	zhèng què	옳은
正式	zhèng shì	형식적인
证明	zhèng míng	알다
之	zhī	의
支持	zhī chí	대기하다
知识	zhī shi	지식
值得	zhí de	그만한 가치
植物	zhí wù	식물
直接	zhí jiē	곧장
职业	zhí yè	직업
只好	zhǐ hǎo	했다
只要	zhǐ yào	하는 한
指	zhǐ	방법
至少	zhì shǎo	적어도
质量	zhì liàng	품질
重	zhòng	무게
重点	zhòng diǎn	초점
重视	zhòng shì	값
周围	zhōu wéi	주위에
主意	zhǔ yi	생각
祝贺	zhù hè	축하하다
著名	zhù míng	유명한
专门	zhuān mén	특화된
专业	zhuān yè	직업
转	zhuǎn	회전
赚	zhuàn	벌다
准确	zhǔn què	정확한
准时	zhǔn shí	정시에
仔细	zǐ xì	꼼꼼한
自然	zì rán	자연스러운
自信	zì xìn	자신
总结	zǒng jié	요약하자면
租	zū	임대
最好	zuì hǎo	최고
尊重	zūn zhòng	존경
左右	zuǒ yòu	약
作家	zuò jiā	작가
作用	zuò yòng	효과
作者	zuò zhě	저자
座	zuò	좌석
座位	zuò wèi	좌석
