挨	ái	참다
癌症	ái zhèng	암
暧昧	ài mèi	모호한
爱不释手	ài bù shì shǒu	내려 놔
爱戴	ài dài	사랑
安宁	ān níng	평화로운
安详	ān xiáng	고요한
安置	ān zhì	놓기
按摩	àn mó	마사지
暗示	àn shì	힌트
案件	àn jiàn	케이스
案例	àn lì	케이스
昂贵	áng guì	비싼
凹凸	āo tū	충돌
熬	áo	종기
奥秘	ào mì	신비
巴不得	bā bù dé	불안
巴结	bā jie	엷은 황갈색
扒	bā	그릴
疤	bā	흉터
拔苗助长	bá miáo zhù zhǎng	뿌리 내리기
把关	bǎ guān	검사
把手	bǎ shǒu	핸들
罢工	bà gōng	스트라이크
霸道	bà dào	뽐내는
掰	bāi	안녕
摆脱	bǎi tuō	제거하다
拜访	bài fǎng	방문
拜年	bài nián	새해 복 많이 받으세요
拜托	bài tuō	부디
败坏	bài huài	부정한
斑	bān	자리
颁布	bān bù	널리 퍼지게 하다
颁发	bān fā	발행물
版本	bǎn běn	버전
伴侣	bàn lv3	동반자
伴随	bàn suí	따르는
半途而废	bàn tú ér fèi	중간에 포기하다
扮演	bàn yǎn	플레이
榜样	bǎng yàng	예
绑架	bǎng jià	유괴
磅	bàng	lb
包庇	bāo bì	피난처
包袱	bāo fu	부담
包围	bāo wéi	포위
包装	bāo zhuāng	꾸러미
保管	bǎo guǎn	보관
保密	bǎo mì	비밀 유지
保姆	bǎo mǔ	안저지
保守	bǎo shǒu	전통적인
保卫	bǎo wèi	지키다
保养	bǎo yǎng	유지
保障	bǎo zhàng	보증
保重	bǎo zhòng	조심하세요
饱和	bǎo hé	포화
饱经沧桑	bǎo jīng cāng sāng	우여곡절
报酬	bào chou	보수
报仇	bào chóu	복수
报答	bào dá	갚다
报复	bào fù	복수
报警	bào jǐng	경찰에 신고
报销	bào xiāo	반제
抱负	bào fù	큰 뜻
暴力	bào lì	폭력
暴露	bào lù	드러난
曝光	bào guāng	노출
爆发	bào fā	탈출하다
爆炸	bào zhà	폭발
卑鄙	bēi bǐ	평균
悲哀	bēi āi	슬픔
悲惨	bēi cǎn	비참한
北极	běi jí	북극
备份	bèi fèn	지원
备忘录	bèi wàng lù	각서
背叛	bèi pàn	팔다
背诵	bèi sòng	암송하다
被动	bèi dòng	수동태
被告	bèi gào	피고
贝壳	bèi ké	껍질
奔波	bēn bō	뛰어 다니다
奔驰	bēn chí	벤츠
本能	běn néng	본능
本钱	běn qián	자본
本人	běn rén	자기
本身	běn shēn	그 자체
本事	běn shi	능력
笨拙	bèn zhuō	모양 없는
崩溃	bēng kuì	무너짐
甭	béng	하지마
蹦	bèng	도약
迸发	bèng fā	파열
逼迫	bī pò	힘
鼻涕	bí tì	코
比方	bǐ fang	예를 들면
比喻	bǐ yù	은유
比重	bǐ zhòng	비율
鄙视	bǐ shì	경멸하다
弊病	bì bìng	불쾌
弊端	bì duān	단점
臂	bì	팔
闭塞	bì sè	막다
编织	biān zhī	짜다
边疆	biān jiāng	국경 지방
边界	biān jiè	경계
边境	biān jìng	경계
边缘	biān yuán	가장자리
鞭策	biān cè	박차
扁	biǎn	플랫
贬低	biǎn dī	얕보다
贬义	biǎn yì	경멸적인
便利	biàn lì	편리한
便条	biàn tiáo	노트
便于	biàn yú	쉽게
变故	biàn gù	불행
变迁	biàn qiān	변화
变质	biàn zhì	부패
辨认	biàn rèn	식별
辩护	biàn hù	지키다
辩解	biàn jiě	변명하다
辩证	biàn zhèng	변증법
辫子	biàn zi	드리다
遍布	biàn bù	온통
标本	biāo běn	표본
标记	biāo jì	표
标题	biāo tí	표제
表决	biǎo jué	투표
表态	biǎo tài	위치
表彰	biǎo zhāng	인식
憋	biē	다시 잡아
别墅	bié shù	별장
别致	bié zhì	우아한
别扭	biè niu	어색한
濒临	bīn lín	직전에
冰雹	bīng báo	빗발
丙	bǐng	씨
并非	bìng fēi	아니
并列	bìng liè	나란히
剥削	bō xuē	공적
拨	bō	다이얼
播种	bō zhòng	파종
波浪	bō làng	웨이브
波涛	bō tāo	파도
伯母	bó mǔ	이모
博大精深	bó dà jīng shēn	광범위하고 심오한
博览会	bó lǎn huì	공정한
搏斗	bó dòu	싸움
薄弱	bó ruò	약한
不顾	bú gù	상관없이
不愧	bú kuì	가치있는
不料	bú liào	뜻밖에
不像话	bú xiàng huà	터무니없는
不屑一顾	bú xiè yī gù	무시
哺乳	bǔ rǔ	모유 수유
捕捉	bǔ zhuō	포착
补偿	bǔ cháng	구성하다
补救	bǔ jiù	치료제
补贴	bǔ tiē	보조금
不得已	bù dé yǐ	최후의 조치
不妨	bù fáng	그럴 수도
不敢当	bù gǎn dāng	감히
不禁	bù jīn	어쩔 수 없어
不堪	bù kān	견딜 수 없는
不可思议	bù kě sī yì	놀랄 만한
不免	bù miǎn	필연적으로
不时	bù shí	때때로
不惜	bù xī	주저하지 말고
不相上下	bù xiāng shàng xià	유사한
不言而喻	bù yán ér yù	그것은 말할 것도 없다
不由得	bù yóu de	어쩔 수 없지만
不择手段	bù zé shǒu duàn	열심히 놀다
不止	bù zhǐ	이상
布告	bù gào	주의
布局	bù jú	형세
布置	bù zhì	형세
步伐	bù fá	속도
部署	bù shǔ	전개
部位	bù wèi	위치
才干	cái gàn	능력
裁缝	cái feng	재단사
裁判	cái pàn	심판
裁员	cái yuán	해고
财富	cái fù	부
财务	cái wù	재원
财政	cái zhèng	재정적 인
彩票	cǎi piào	운
采购	cǎi gòu	매수
采集	cǎi jí	수집
采纳	cǎi nà	양자
参谋	cān móu	직원
参照	cān zhào	참고
残疾	cán jí	무능
残酷	cán kù	잔인한
残留	cán liú	잔여
残忍	cán rěn	잔인한
灿烂	càn làn	훌륭한
仓促	cāng cù	급한
仓库	cāng kù	창고
舱	cāng	선실
苍白	cāng bái	창백한
操劳	cāo láo	열심히 일하다
操练	cāo liàn	연습
操纵	cāo zòng	교묘히 다루다
操作	cāo zuò	운영
嘈杂	cáo zá	시끄러운
草案	cǎo àn	초안
草率	cǎo shuài	급한
侧面	cè miàn	측면
测量	cè liáng	자질
策划	cè huà	계획
策略	cè lvè	전략
层出不穷	céng chū bù qióng	끝없는
层次	céng cì	수평
差别	chā bié	차
插座	chā zuò	소켓
查获	chá huò	압수
刹那	chà nà	순간
岔	chà	포크
诧异	chà yì	놀란
柴油	chái yóu	디젤 유
搀	chān	혼합
缠绕	chán rào	굴곡
馋	chán	탐욕스러운
产业	chǎn yè	산업
阐述	chǎn shù	정교한
颤抖	chàn dǒu	떨림
昌盛	chāng shèng	번영
偿还	cháng huán	갚다
尝试	cháng shì	시험
场合	chǎng hé	기회
场面	chǎng miàn	장면
场所	chǎng suǒ	장소
敞开	chǎng kāi	활짝 열려
倡导	chàng dǎo	대변자
倡议	chàng yì	발의
畅通	chàng tōng	차단 해제
畅销	chàng xiāo	베스트셀러
超越	chāo yuè	을 넘어서
钞票	chāo piào	지폐
嘲笑	cháo xiào	이빨을 날리다
巢穴	cháo xué	둥지
朝代	cháo dài	왕조
潮流	cháo liú	경향
撤退	chè tuì	후퇴
撤销	chè xiāo	취소
沉淀	chén diàn	침적
沉闷	chén mèn	단조롭고 지루한
沉思	chén sī	심사 숙고
沉重	chén zhòng	무거운
沉着	chén zhuó	고요한
陈旧	chén jiù	구식
陈列	chén liè	디스플레이
陈述	chén shù	성명서
称心如意	chèn xīn rú yì	만족
衬托	chèn tuō	출발하다
称号	chēng hào	표제
乘	chéng	곱하다
呈现	chéng xiàn	선물
城堡	chéng bǎo	성
惩罚	chéng fá	처벌
成本	chéng běn	비용
成交	chéng jiāo	거래
成天	chéng tiān	하루 종일
成效	chéng xiào	유효성
成心	chéng xīn	신중히
成员	chéng yuán	회원
承办	chéng bàn	맡다
承包	chéng bāo	계약
承诺	chéng nuò	약속
橙	chéng	주황색
澄清	chéng qīng	밝히다
盛	chéng	sheng
诚挚	chéng zhì	성실한
秤	chèng	저울
吃苦	chī kǔ	참다
吃力	chī lì	격렬한
持久	chí jiǔ	일종의 튼튼한 나사
迟钝	chí dùn	느린
迟缓	chí huǎn	느린
迟疑	chí yí	서슴다
赤道	chì dào	매우 무더운
赤字	chì zì	적자
充当	chōng dāng	역할을하다
充沛	chōng pèi	풍부한
充实	chōng shí	높이다
充足	chōng zú	적당한
冲动	chōng dòng	충동
冲击	chōng jī	충격
冲突	chōng tū	충돌
崇拜	chóng bài	예배
崇高	chóng gāo	숭고한
崇敬	chóng jìng	존경
重叠	chóng dié	겹침
稠密	chóu mì	밀집한
筹备	chóu bèi	예비
丑恶	chǒu è	추한
出路	chū lù	출구
出卖	chū mài	팔다
出身	chū shēn	유래
出神	chū shén	황홀
出息	chū xi	훌륭해
初步	chū bù	예비
除	chú	외
储备	chǔ bèi	비축
储存	chǔ cún	저장
储蓄	chǔ xù	저금
处分	chǔ fèn	제재
处境	chǔ jìng	상태
处置	chǔ zhì	을 없애다, 처리하다
触犯	chù fàn	공격하다
川流不息	chuān liú bù xī	상수 스트림
穿越	chuān yuè	횡단
传达	chuán dá	나르다
传单	chuán dān	전단
传授	chuán shòu	가르치다
船舶	chuán bó	배
喘气	chuǎn qì	바지
串	chuàn	끈
床单	chuáng dān	침대 시트
创立	chuàng lì	설립
创新	chuàng xīn	혁신
创业	chuàng yè	사업을 시작하다
创作	chuàng zuò	창조
吹牛	chuī niú	자랑
吹捧	chuī pěng	즐겁게 하다
炊烟	chuī yān	연기 요리
垂直	chuí zhí	세로
锤	chuí	망치
纯粹	chún cuì	전혀
纯洁	chún jié	순수한
慈善	cí shàn	자비로운
慈祥	cí xiáng	친절한
磁带	cí dài	줄자
雌雄	cí xióng	남성과 여성
伺候	cì hòu	서브
刺	cì	가시
次品	cì pǐn	결함 있는
次序	cì xù	주문
丛	cóng	덩어리
从容	cóng róng	고요히
凑合	còu he	즉석에서
粗鲁	cū lǔ	무례한
窜	cuàn	채널
摧残	cuī cán	폐허
脆弱	cuì ruò	깨지기 쉬운
搓	cuō	트위스트
磋商	cuō shāng	상의
挫折	cuò zhé	좌절
搭	dā	갖다
搭档	dā dàng	파트너
搭配	dā pèi	시합
答辩	dá biàn	댓글
答复	dá fù	댓글
达成	dá chéng	범위
打包	dǎ bāo	곤포
打官司	dǎ guān si	소송
打击	dǎ jī	타격
打架	dǎ jià	싸움
打量	dǎ liang	보다
打猎	dǎ liè	사냥
打仗	dǎ zhàng	싸움
大不了	dà bù liǎo	큰 거래
大臣	dà chén	장관
大伙儿	dà huǒ r	여러분
大肆	dà sì	wantonly
大体	dà tǐ	일반적으로
大意	dà yì	주요 아이디어
大致	dà zhì	대략
歹徒	dǎi tú	갱 단원
代价	dài jià	비용
代理	dài lǐ	대리
带领	dài lǐng	리드
怠慢	dài màn	태만
逮捕	dài bǔ	체포
担保	dān bǎo	보증
胆怯	dǎn qiè	소심한
淡季	dàn jì	오프 시즌
淡水	dàn shuǐ	담수
蛋白质	dàn bái zhì	단백질
诞辰	dàn chén	생신
诞生	dàn shēng	태어난
当场	dāng chǎng	그 자리에서
当初	dāng chū	처음에
当代	dāng dài	현대
当面	dāng miàn	면 대면
当前	dāng qián	흐름
当事人	dāng shì rén	파티
当务之急	dāng wù zhī jí	피할 수 없는
当选	dāng xuǎn	선출
党	dǎng	파티
档案	dàng àn	파일
档次	dàng cì	등급
倒闭	dǎo bì	무너짐
导弹	dǎo dàn	미사일
导航	dǎo háng	항해
导向	dǎo xiàng	안내서
捣乱	dǎo luàn	문제를 만들다
盗窃	dào qiè	훔침
稻谷	dào gǔ	아일랜드 사람
得不偿失	dé bù cháng shī	손실 가치 없음
得力	dé lì	유효한
得天独厚	dé tiān dú hòu	축복 받은
得罪	dé zuì	공격하다
灯笼	dēng lóng	칸델라
登录	dēng lù	로그인
登陆	dēng lù	로그인
蹬	dēng	발 차기
等候	děng hòu	기다리는
等级	děng jí	등급
瞪	dèng	응시
堤坝	dī bà	댐
敌视	dí shì	적의
抵达	dǐ dá	도착
抵抗	dǐ kàng	저항
抵制	dǐ zhì	견디다
地步	dì bù	포인트
地势	dì shì	지역
地质	dì zhì	지질학
递增	dì zēng	증가하다
颠簸	diān bǒ	범프
颠倒	diān dǎo	역전
典礼	diǎn lǐ	의식
典型	diǎn xíng	전형적인
点缀	diǎn zhuì	꾸밈
垫	diàn	인주
奠定	diàn dìng	위치
惦记	diàn jì	걱정
电源	diàn yuán	전원 공급
叼	diāo	매달다
雕刻	diāo kè	조각
雕塑	diāo sù	조각
吊	diào	매달다
调动	diào dòng	동원
跌	diē	가을
丁	dīng	땡땡
叮嘱	dīng zhǔ	간곡히 타이르다
盯	dīng	응시
定期	dìng qī	정규병
定义	dìng yì	정의
丢人	diū rén	부끄러움
丢三落四	diū sān là sì	모든 것을 잃는다
东道主	dōng dào zhǔ	주최자
东张西望	dōng zhāng xī wàng	둘러보고
董事长	dǒng shì zhǎng	의장
冻结	dòng jié	얼다
动荡	dòng dàng	소란
动机	dòng jī	자극
动静	dòng jìng	운동
动力	dòng lì	힘
动脉	dòng mài	동맥
动身	dòng shēn	떠나다
动手	dòng shǒu	손에
动态	dòng tài	동적
动员	dòng yuán	동원
栋	dòng	동
兜	dōu	포켓
陡峭	dǒu qiào	험한
斗争	dòu zhēng	노력
督促	dū cù	충동
毒品	dú pǐn	의약품
独裁	dú cái	절대권
堵塞	dǔ sè	막힘
赌博	dǔ bó	도박
杜绝	dù jué	에 종지부를 찍을
端	duān	종료
端午节	duān wǔ jié	드래곤 보트 축제
端正	duān zhèng	옳은
短促	duǎn cù	짧은
断定	duàn dìng	결정
断绝	duàn jué	끊다
堆积	duī jī	축적
兑现	duì xiàn	현금
对策	duì cè	대항책
对称	duì chèn	대칭
对付	duì fu	다루다
对抗	duì kàng	직면
对立	duì lì	반대
对联	duì lián	이행 연구
对应	duì yìng	대응하다
对照	duì zhào	제어
队伍	duì wu	팀
顿时	dùn shí	갑자기
哆嗦	duō suo	떨림
多元化	duō yuán huà	다각화
堕落	duò luò	타락한
额外	é wài	추가
恶心	ě xin	구역질
恶化	è huà	악화
遏制	è zhì	있다
恩怨	ēn yuàn	원한
而已	ér yǐ	그게 다야
二氧化碳	èr yǎng huà tàn	이산화탄소
发布	fā bù	해제
发财	fā cái	부자되기
发呆	fā dāi	현혹
发动	fā dòng	시작하다
发觉	fā jué	찾기
发射	fā shè	방사
发誓	fā shì	저주
发行	fā xíng	발행 된
发炎	fā yán	발열
发扬	fā yáng	이월하다
发育	fā yù	개발
法人	fǎ rén	법인
番	fān	부채
凡是	fán shì	모두
繁华	fán huá	붐비는
繁忙	fán máng	바쁜
繁体字	fán tǐ zì	중국어 번체
繁殖	fán zhí	일으키다
反驳	fǎn bó	반박하다
反常	fǎn cháng	이상
反感	fǎn gǎn	싫어함
反抗	fǎn kàng	반란
反馈	fǎn kuì	피드백
反面	fǎn miàn	부정
反射	fǎn shè	반사
反思	fǎn sī	반사
反问	fǎn wèn	수사적 질문
反之	fǎn zhī	반대로
泛滥	fàn làn	홍수
范畴	fàn chóu	범주
贩卖	fàn mài	팔다
方位	fāng wèi	위치
方言	fāng yán	방언
方圆	fāng yuán	fangyuan
方针	fāng zhēn	수단
防守	fáng shǒu	방어
防御	fáng yù	방어
防止	fáng zhǐ	막다
防治	fáng zhì	제어
纺织	fǎng zhī	직물
访问	fǎng wèn	접속하다
放大	fàng dà	크게 하다
放射	fàng shè	방사능
非法	fēi fǎ	불법
飞禽走兽	fēi qín zǒu shòu	조수
飞翔	fēi xiáng	파리
飞跃	fēi yuè	뛰기
肥沃	féi wò	비옥함
诽谤	fěi bàng	중상
废除	fèi chú	폐지
废寝忘食	fèi qǐn wàng shí	잠 못 이루는
废墟	fèi xū	유적
沸腾	fèi téng	비등
肺	fèi	폐
分辨	fēn biàn	드러내다
分寸	fēn cun	법안
分红	fēn hóng	배당금
分解	fēn jiě	분해하다
分裂	fēn liè	스플릿
分泌	fēn mì	분비
分明	fēn míng	뚜렷한
分歧	fēn qí	불쾌한 일
分散	fēn sàn	분산
吩咐	fēn fù	주문
坟墓	fén mù	묘
粉末	fěn mò	가루
粉色	fěn sè	분홍
粉碎	fěn suì	스매시
分量	fèn liàng	일부
愤怒	fèn nù	분노
丰满	fēng mǎn	완전한
丰盛	fēng shèng	풍부한
丰收	fēng shōu	풍부한 수확
封闭	fēng bì	닫은
封建	fēng jiàn	봉건적
封锁	fēng suǒ	봉쇄
锋利	fēng lì	날카로운
风暴	fēng bào	폭풍
风度	fēng dù	행실
风光	fēng guāng	풍경
风气	fēng qì	분위기
风趣	fēng qù	이상한
风土人情	fēng tǔ rén qíng	지역 문화
风味	fēng wèi	맛
逢	féng	마다
奉献	fèng xiàn	봉납
否决	fǒu jué	거부권
夫妇	fū fù	두
夫人	fū ren	레이디
敷衍	fū yǎn	perfunctory
俘虏	fú lǔ	포로
幅度	fú dù	진폭
服从	fú cóng	순종하다
服气	fú qì	확신
福利	fú lì	복지
福气	fú qi	축복
符号	fú hào	상징
辐射	fú shè	방사능
俯视	fǔ shì	아래를 봐
抚摸	fǔ mō	쓰다듬어
抚养	fǔ yǎng	올리다
腐败	fǔ bài	부패
腐烂	fǔ làn	썩음
腐蚀	fǔ shí	부식
腐朽	fǔ xiǔ	부식
辅助	fǔ zhù	돕다
副	fù	바이스
复活	fù huó	부활
复兴	fù xīng	회복
富裕	fù yù	풍부한
腹泻	fù xiè	설사
覆盖	fù gài	덮개
负担	fù dān	부담
赋予	fù yǔ	주기
附和	fù hè	따라 가다
附件	fù jiàn	신관
附属	fù shǔ	붙여진
改良	gǎi liáng	돌리다
盖章	gài zhāng	우표
钙	gài	칼슘
尴尬	gān gà	어색한
干旱	gān hàn	가뭄
干扰	gān rǎo	간섭
干涉	gān shè	노를 넣다
干预	gān yù	개입
感慨	gǎn kǎi	한숨
感染	gǎn rǎn	감염
干劲	gàn jìn	열광
扛	gāng	나르다
纲领	gāng lǐng	프로그램
岗位	gǎng wèi	게시하다
港口	gǎng kǒu	포트
港湾	gǎng wān	항구
杠杆	gàng gǎn	지렛대
高超	gāo chāo	훌륭한
高潮	gāo cháo	클라이맥스
高峰	gāo fēng	피크
高明	gāo míng	영리한
高尚	gāo shàng	고귀한
高涨	gāo zhǎng	활상
稿件	gǎo jiàn	원고
告辞	gào cí	작별
告诫	gào jiè	타이르다
割	gē	절단
搁	gē	놓다
歌颂	gē sòng	칭찬
疙瘩	gē da	여드름
鸽子	gē zi	비둘기
格局	gé jú	무늬
格式	gé shì	체재
隔阂	gé hé	갭
隔离	gé lí	격리
革命	gé mìng	혁명
个体	gè tǐ	개인
各抒己见	gè shū jǐ jiàn	의견 표현
根深蒂固	gēn shēn dì gù	뿌리 깊은
根源	gēn yuán	출처
跟前	gēn qián	앞에
跟随	gēn suí	따르다
跟踪	gēn zōng	과정
更新	gēng xīn	최신 정보
更正	gēng zhèng	옳은
耕地	gēng dì	경지
供不应求	gōng bù yìng qiú	공급 부족
供给	gōng jǐ	공급
公安局	gōng ān jú	공안국
公道	gōng dào	정의
公告	gōng gào	발표
公关	gōng guān	pr
公民	gōng mín	시민
公然	gōng rán	공공연히
公认	gōng rèn	수락 됨
公式	gōng shì	공식
公务	gōng wù	관용
公正	gōng zhèng	다만
公证	gōng zhèng	공증
功劳	gōng láo	신용
功效	gōng xiào	효과
宫殿	gōng diàn	궁전
工艺品	gōng yì pǐn	공예
恭敬	gōng jìng	존중
攻击	gōng jī	공격
攻克	gōng kè	포착
巩固	gǒng gù	통합
共和国	gòng hé guó	공화국
共计	gòng jì	합계
共鸣	gòng míng	공명
勾结	gōu jié	collude
钩子	gōu zi	훅
构思	gòu sī	생각
姑且	gū qiě	잠정적으로
孤独	gū dú	고독한
孤立	gū lì	외딴
辜负	gū fù	아래로
古董	gǔ dǒng	고대 미술
古怪	gǔ guài	별난
股东	gǔ dōng	주주
股份	gǔ fèn	주식
骨干	gǔ gàn	등뼈
鼓动	gǔ dòng	흔들다
固然	gù rán	물론이야
固体	gù tǐ	고체
固有	gù yǒu	타고난
固执	gù zhi	완고한
故乡	gù xiāng	집
故障	gù zhàng	부조
雇佣	gù yōng	고용하다
顾虑	gù lv4	관심사
顾问	gù wèn	컨설턴트
拐杖	guǎi zhàng	버팀목
关怀	guān huái	케어
关照	guān zhào	케어
官方	guān fāng	공무원
观光	guān guāng	관광하러 가다
管辖	guǎn xiá	관할권
惯例	guàn lì	협약
灌溉	guàn gài	관개
罐	guàn	탱크
贯彻	guàn chè	도구
光彩	guāng cǎi	거룩한
光辉	guāng huī	거룩한
光芒	guāng máng	빛
光荣	guāng róng	영광
广阔	guǎng kuò	넓은
归根到底	guī gēn dào dǐ	최종 분석에서
归还	guī huán	반환
规范	guī fàn	사양
规格	guī gé	사양
规划	guī huà	계획
规章	guī zhāng	규정
轨道	guǐ dào	과정
贵族	guì zú	고귀한
跪	guì	무릎을 꿇다
棍棒	gùn bàng	스틱
国防	guó fáng	국방
国务院	guó wù yuàn	주의회
果断	guǒ duàn	결정적인
过度	guò dù	위에
过渡	guò dù	전이
过奖	guò jiǎng	과대 평가
过滤	guò lv4	필터
过失	guò shī	결점
过问	guò wèn	개입
过瘾	guò yǐn	재미있는
过于	guò yú	너무
嗨	hāi	안녕하세요
海拔	hǎi bá	고도
海滨	hǎi bīn	해안
含糊	hán hu	막연한
含义	hán yì	의미
寒暄	hán xuān	인사
罕见	hǎn jiàn	드문
捍卫	hàn wèi	지키다
航空	háng kōng	비행
航天	háng tiān	항공 우주
航行	háng xíng	항해
行列	háng liè	순위
毫米	háo mǐ	음
毫无	háo wú	아무것도
豪迈	háo mài	과장된 어조
号召	hào zhào	을 요구하다
耗费	hào fèi	비용
呵	hē	아
合并	hé bìng	병합
合成	hé chéng	합성
合伙	hé huǒ	협력 관계
合算	hé suàn	비용 효율적
和蔼	hé ǎi	종류
和解	hé jiě	화해
和睦	hé mù	조화
和气	hé qi	친절
和谐	hé xié	조화로운
嘿	hēi	야
痕迹	hén jì	자취
狠心	hěn xīn	무정한
恨不得	hèn bu dé	기다릴 수 없어
哼	hēng	험프
横	héng	수평
哄	hōng	동축 케이블
烘	hōng	빵 굽기
轰动	hōng dòng	감각
宏观	hóng guān	매크로
宏伟	hóng wěi	웅장 함
洪水	hóng shuǐ	홍수
喉咙	hóu lóng	목
吼	hǒu	노호
候选	hòu xuǎn	후보자
后代	hòu dài	자식
后顾之忧	hòu gù zhī yōu	걱정
后勤	hòu qín	물류 센터
呼唤	hū huàn	요구
呼啸	hū xiào	멀리서 짖는 소리
呼吁	hū yù	요구
忽略	hū lvè	무시하다
湖泊	hú pō	호수
胡乱	hú luàn	우연히
胡须	hú xū	수염
花瓣	huā bàn	꽃잎
花蕾	huā lěi	싹
华丽	huá lì	화려한
华侨	huá qiáo	화교
划分	huà fēn	나누기
化肥	huà féi	비료
化石	huà shí	화석
化验	huà yàn	시험
化妆	huà zhuāng	구성하다
画蛇添足	huà shé tiān zú	불필요한
话筒	huà tǒng	마이크로폰
欢乐	huān lè	즐거움
环节	huán jié	링크
还原	huán yuán	절감
缓和	huǎn hé	용이함
患者	huàn zhě	환자
荒凉	huāng liáng	황량한
荒谬	huāng miù	불합리한
荒唐	huāng táng	불합리한
皇帝	huáng dì	황제
皇后	huáng hòu	퀸
黄昏	huáng hūn	황혼
恍然大悟	huǎng rán dà wù	갑자기 깨달음
晃	huǎng	떨림
挥霍	huī huò	과시
辉煌	huī huáng	훌륭한
回报	huí bào	반환
回避	huí bì	기피
回顾	huí gù	리뷰
回收	huí shōu	재활용
悔恨	huǐ hèn	자책감
毁灭	huǐ miè	멸하다
会晤	huì wù	모임
汇报	huì bào	보고서
贿赂	huì lù	뇌물
昏迷	hūn mí	혼수
荤	hūn	고기
浑身	hún shēn	온통
混合	hùn hé	혼입
混乱	hùn luàn	착란
混淆	hùn xiáo	휘두르다
混浊	hùn zhuó	흐린
活该	huó gāi	그럴만 한 자격이
活力	huó lì	활력
火箭	huǒ jiàn	로켓
火焰	huǒ yàn	불꽃
火药	huǒ yào	화약
货币	huò bì	통화
基地	jī dì	베이스
基金	jī jīn	축적
基因	jī yīn	유전자
机动	jī dòng	운동
机构	jī gòu	기구
机灵	jī ling	영리한
机密	jī mì	기밀
机械	jī xiè	기계적
机遇	jī yù	기회
机智	jī zhì	재치 있는
激发	jī fā	자극
激励	jī lì	자극
激情	jī qíng	열정
讥笑	jī xiào	비웃음
饥饿	jī è	굶주림
即便	jí biàn	설사
即将	jí jiāng	곧 출시
及早	jí zǎo	이른
吉祥	jí xiáng	길조
嫉妒	jí dù	질투심 많은
急功近利	jí gōng jìn lì	빠른 성공
急剧	jí jù	날카로운
急切	jí qiè	심한
急于求成	jí yú qiú chéng	성공에 대한 열망
急躁	jí zào	참을성이없는
极端	jí duān	극단
极限	jí xiàn	한도
疾病	jí bìng	질병
籍贯	jí guàn	고향
级别	jí bié	수평
集团	jí tuán	그룹
给予	jǐ yǔ	주기
季军	jì jūn	세 번째 장소
季度	jì dù	계간지
寂静	jì jìng	침묵
寄托	jì tuō	맡기다
忌讳	jì huì	금기
技巧	jì qiǎo	기술
纪要	jì yào	요약
继承	jì chéng	상속하다
计较	jì jiào	관심
记性	jì xing	기억
记载	jì zǎi	기록
迹象	jì xiàng	기호
佳肴	jiā yáo	섬세
加工	jiā gōng	가공
加剧	jiā jù	강하게 하다
夹杂	jiā zá	포함
家常	jiā cháng	검소한
家伙	jiā huo	사람
家属	jiā shǔ	가족 구성원들
家喻户晓	jiā yù hù xiǎo	잘 알려진
坚定	jiān dìng	상사
坚固	jiān gù	상사
坚韧	jiān rèn	강인한
坚实	jiān shí	고체
坚硬	jiān yìng	단단한
尖端	jiān duān	팁
尖锐	jiān ruì	날카로운
煎	jiān	볶은 것
监督	jiān dū	감독
监视	jiān shì	감시 장치
监狱	jiān yù	감옥
艰难	jiān nán	어려운
剪彩	jiǎn cǎi	리본 자르기
拣	jiǎn	선택
检讨	jiǎn tǎo	리뷰
检验	jiǎn yàn	테스트
简化	jiǎn huà	단순화
简陋	jiǎn lòu	조잡한
简体字	jiǎn tǐ zì	중국어 간체
简要	jiǎn yào	간결한
健全	jiàn quán	소리
剑	jiàn	검
溅	jiàn	튀김
舰艇	jiàn tǐng	배
见多识广	jiàn duō shí guǎng	지식이있는
见解	jiàn jiě	의견
见闻	jiàn wén	지식
见义勇为	jiàn yì yǒng wéi	신이 옳다고 하다
践踏	jiàn tà	짓밟다
鉴别	jiàn bié	식별
鉴定	jiàn dìng	신분증
鉴于	jiàn yú	주어진
间谍	jiàn dié	스파이
间隔	jiàn gé	간격
间接	jiàn jiē	간접
僵硬	jiāng yìng	딱딱한
将军	jiāng jūn	일반
将近	jiāng jìn	거의
将就	jiāng jiù	될거야
奖励	jiǎng lì	보상
奖赏	jiǎng shǎng	보상
桨	jiǎng	외륜
降临	jiàng lín	왔다
交叉	jiāo chā	가로 질러 가다
交代	jiāo dài	설명
交涉	jiāo shè	협상
交易	jiāo yì	트랜잭션
娇气	jiāo qì	스쿼 미시
焦点	jiāo diǎn	초점
焦急	jiāo jí	불안
侥幸	jiǎo xìng	행운
搅拌	jiǎo bàn	휘젓다
缴纳	jiǎo nà	지불
角落	jiǎo luò	모서리
教养	jiào yǎng	육성
较量	jiào liàng	대회
接连	jiē lián	연속
揭露	jiē lù	폭로
皆	jiē	모두
阶层	jiē céng	수업
截止	jié zhǐ	끊다
截至	jié zhì	현재
杰出	jié chū	훌륭해
竭尽全力	jié jìn quán lì	최선을 다해
结晶	jié jīng	결정화
结局	jié jú	종결
结算	jié suàn	정착
节制	jié zhì	제어
节奏	jié zòu	율
解除	jiě chú	버리다
解放	jiě fàng	해방
解雇	jiě gù	해임
解剖	jiě pōu	해부
解散	jiě sàn	해체
解体	jiě tǐ	분해
借鉴	jiè jiàn	빌다
借助	jiè zhù	의 도움으로
戒备	jiè bèi	경보
界限	jiè xiàn	한도
津津有味	jīn jīn yǒu wèi	양념으로
金融	jīn róng	재정적 인
紧迫	jǐn pò	긴급한
锦上添花	jǐn shàng tiān huā	케이크에 착빙
晋升	jìn shēng	프로모션
浸泡	jìn pào	침액
近来	jìn lái	최근에
进而	jìn ér	그리고
进攻	jìn gōng	공격
进化	jìn huà	진화
进展	jìn zhǎn	진행
兢兢业业	jīng jīng yè yè	양심적
惊动	jīng dòng	방해하다
惊奇	jīng qí	놀라다
惊讶	jīng yà	놀란
精打细算	jīng dǎ xì suàn	신중하게 계획
精华	jīng huá	본질
精简	jīng jiǎn	유선
精密	jīng mì	정도
精确	jīng què	정확한
精通	jīng tōng	능숙한
精心	jīng xīn	정교한
精益求精	jīng yì qiú jīng	계속 개선
精致	jīng zhì	절묘한
经费	jīng fèi	자금
经纬	jīng wěi	위도와 경도
茎	jīng	줄기
井	jǐng	잘
警告	jǐng gào	경고
警惕	jǐng tì	경보
颈椎	jǐng zhuī	경추
境界	jìng jiè	왕국
敬礼	jìng lǐ	경례
敬业	jìng yè	전용
竞赛	jìng sài	경쟁
竞选	jìng xuǎn	운동
镜头	jìng tóu	렌즈
纠纷	jiū fēn	분쟁
纠正	jiū zhèng	옳은
酒精	jiǔ jīng	알코올
就近	jiù jìn	근처
就业	jiù yè	고용
就职	jiù zhí	취임
救济	jiù jì	구조
居民	jū mín	거주자
居住	jū zhù	라이브
拘留	jū liú	구류
拘束	jū shù	제지
鞠躬	jū gōng	활
局部	jú bù	부분
局面	jú miàn	상태
局势	jú shì	상태
局限	jú xiàn	한계
举动	jǔ dòng	움직임
举世瞩目	jǔ shì zhǔ mù	전 세계의 관심을 끌기
举足轻重	jǔ zú qīng zhòng	추축 같은
咀嚼	jǔ jué	씹다
沮丧	jǔ sàng	실망한
剧本	jù běn	스크립트
剧烈	jù liè	중증
据悉	jù xī	보고된다
聚精会神	jù jīng huì shén	집중
卷	juǎn	음량
倔强	jué jiàng	완고한
决策	jué cè	의사 결정
绝望	jué wàng	절망
觉悟	jué wù	의식
觉醒	jué xǐng	각성
军队	jūn duì	육군
君子	jūn zǐ	신사
卡通	kǎ tōng	만화
开采	kāi cǎi	채광
开除	kāi chú	추방
开阔	kāi kuò	열다
开朗	kāi lǎng	쾌활한
开明	kāi míng	밝은
开辟	kāi pì	열다
开拓	kāi tuò	열다
开展	kāi zhǎn	나타나게 하다
开支	kāi zhī	지출
刊登	kān dēng	게시
刊物	kān wù	출판
勘探	kān tàn	탐구
侃侃而谈	kǎn kǎn ér tán	자유롭게 이야기
砍伐	kǎn fá	벌목
看待	kàn dài	보다
慷慨	kāng kǎi	풍부한
抗议	kàng yì	항의
考察	kǎo chá	서베이
考古	kǎo gǔ	고고학
考核	kǎo hé	평가
考验	kǎo yàn	테스트
靠拢	kào lǒng	가까이 다가가
磕	kē	노크
科目	kē mù	제목
可观	kě guān	많은
可口	kě kǒu	맛좋은
可恶	kě wù	증오
可行	kě xíng	실현 가능 한
渴望	kě wàng	염원
克制	kè zhì	제지
刻不容缓	kè bù róng huǎn	지체 할 시간 없음
客户	kè hù	고객
课题	kè tí	제목
啃	kěn	물다
恳切	kěn qiè	성실한
坑	kēng	피트
空洞	kōng dòng	구멍
空前绝后	kōng qián jué hòu	새로운
空想	kōng xiǎng	공상
空虚	kōng xū	공
孔	kǒng	구멍
恐怖	kǒng bù	공포
恐吓	kǒng hè	협박
恐惧	kǒng jù	무서움
空白	kòng bái	공백
空隙	kòng xì	갭
口气	kǒu qì	음정
口腔	kǒu qiāng	구강
口头	kǒu tóu	경구
口音	kǒu yīn	악센트
扣	kòu	버클
哭泣	kū qì	울음 소리
枯萎	kū wěi	시든
枯燥	kū zào	단조롭고 지루한
苦尽甘来	kǔ jìn gān lái	신랄
苦涩	kǔ sè	쓴
挎	kuà	나르다
跨	kuà	스팬
快活	kuài huo	행복
宽敞	kuān chang	널찍한
宽容	kuān róng	관대 한
款待	kuǎn dài	환대
款式	kuǎn shì	스타일
筐	kuāng	바구니
况且	kuàng qiě	게다가
旷课	kuàng kè	장기 결석
框架	kuàng jià	틀
矿产	kuàng chǎn	광물
亏待	kuī dài	나쁘게 대하다
亏损	kuī sǔn	손실
捆绑	kǔn bǎng	묶여
扩充	kuò chōng	확장
扩散	kuò sàn	확산
扩张	kuò zhāng	확장
啦	lā	라
喇叭	lǎ ba	스피커
蜡烛	là zhú	양초
来历	lái lì	유래
来源	lái yuán	출처
栏目	lán mù	기둥
懒惰	lǎn duò	게으른
狼狈	láng bèi	어리둥절한
狼吞虎咽	láng tūn hǔ yàn	늑대
捞	lāo	물고기
唠叨	láo dao	잔소리
牢固	láo gù	상사
牢骚	láo sāo	불평
乐趣	lè qù	낙
乐意	lè yì	자발적인
雷达	léi dá	레이더
类似	lèi sì	비슷한
冷酷	lěng kù	잔인한
冷落	lěng luò	제외
冷却	lěng què	식히다
愣	lèng	동결
黎明	lí míng	새벽
理睬	lǐ cǎi	주의
理所当然	lǐ suǒ dāng rán	물론이야
理直气壮	lǐ zhí qì zhuàng	똑바로
理智	lǐ zhì	이유
礼节	lǐ jié	에티켓
礼尚往来	lǐ shàng wǎng lái	상호 상태
里程碑	lǐ chéng bēi	획기적 사건
例外	lì wài	예외
利害	lì hài	말뚝
力求	lì qiú	노력
力所能及	lì suǒ néng jí	우리의 힘 안에서
力争	lì zhēng	싸우다
历代	lì dài	역사
历来	lì lái	항상
立场	lì chǎng	위치
立方	lì fāng	입방체
立交桥	lì jiāo qiáo	고가 도로
立体	lì tǐ	3 차원
立足	lì zú	에 서
粒	lì	곡물
廉洁	lián jié	깨끗한
联欢	lián huān	함께하세요
联络	lián luò	연결
联盟	lián méng	동맹
联想	lián xiǎng	lenovo
连年	lián nián	해가 갈수록
连锁	lián suǒ	체인
连同	lián tóng	함께
良心	liáng xīn	양심
晾	liàng	공기
谅解	liàng jiě	이해
辽阔	liáo kuò	거대한
列举	liè jǔ	세다
临床	lín chuáng	객관적인
淋	lín	샤워
吝啬	lìn sè	적은
伶俐	líng lì	똑똑한
凌晨	líng chén	이른 아침
灵感	líng gǎn	영감
灵魂	líng hún	영혼
灵敏	líng mǐn	민감한
零星	líng xīng	때때로 일어나는
领会	lǐng huì	이해하다
领事馆	lǐng shì guǎn	영사관
领土	lǐng tǔ	영토
领悟	lǐng wù	이해
领先	lǐng xiān	리드
领袖	lǐng xiù	리더
溜	liū	슬립
流浪	liú làng	방랑
流露	liú lù	창틀
流氓	liú máng	도적
流通	liú tōng	순환
留恋	liú liàn	노스탤지어
留念	liú niàn	기념품
留神	liú shén	조심해
聋哑	lóng yǎ	귀머거리와 벙어리
隆重	lóng zhòng	멋진
垄断	lǒng duàn	전매권
笼罩	lǒng zhào	가려진
搂	lǒu	포옹
炉灶	lú zào	난로
轮船	lún chuán	기선
轮廓	lún kuò	윤곽
轮胎	lún tāi	타이어
论坛	lùn tán	법정
论证	lùn zhèng	논의
啰唆	luō suo	성가신
络绎不绝	luò yì bù jué	끝없는 스트림
落成	luò chéng	완료
落实	luò shí	도구
屡次	lv3 cì	자꾸
履行	lv3 xíng	다하다
掠夺	lvè duó	약탈
嘛	ma	잘
麻痹	má bì	마비
麻木	má mù	얼어서 고움
麻醉	má zuì	마취
码头	mǎ tóu	교각
蚂蚁	mǎ yǐ	개미
埋伏	mái fú	매복
埋没	mái mò	매장
埋葬	mái zàng	묻다
脉搏	mài bó	펄스
迈	mài	단계
埋怨	mán yuàn	불평
慢性	màn xìng	만성병 환자
漫长	màn cháng	긴
漫画	màn huà	만화
蔓延	màn yán	확산
忙碌	máng lù	바쁜
盲目	máng mù	맹목적으로
茫茫	máng máng	거대한
茫然	máng rán	헤매다
冒充	mào chōng	가장
冒犯	mào fàn	공격하다
茂盛	mào shèng	융성
媒介	méi jiè	매질
枚	méi	조각
美观	měi guān	아름다운
美满	měi mǎn	행복
美妙	měi miào	훌륭한
萌芽	méng yá	싹
猛烈	měng liè	격렬한
眯	mī	곁눈질
弥补	mí bǔ	구성하다
弥漫	mí màn	퍼지다
谜语	mí yǔ	수수께끼
迷惑	mí huo	휘두르다
迷人	mí rén	매력적인
迷信	mí xìn	미신
密度	mì dù	밀도
密封	mì fēng	봉인
棉花	mián hua	면
免得	miǎn de	...하지 않도록
免疫	miǎn yì	면역
勉励	miǎn lì	북돋우다
勉强	miǎn qiǎng	마지 못해
面貌	miàn mào	얼굴
面子	miàn zi	얼굴
描绘	miáo huì	묘사
瞄准	miáo zhǔn	목표
渺小	miǎo xiǎo	작은
藐视	miǎo shì	경멸
灭亡	miè wáng	몹시 괴롭히다
蔑视	miè shì	경멸
民间	mín jiān	사람들
民主	mín zhǔ	민주주의
敏捷	mǐn jié	기민한
敏锐	mǐn ruì	날카로운
名次	míng cì	순위
名额	míng é	몫
名副其实	míng fù qí shí	이름의 가치
名誉	míng yù	평판
明明	míng míng	명백하게
明智	míng zhì	슬기로운
命名	mìng míng	이름
摸索	mō suo	모색
摩擦	mó cā	마찰
模范	mó fàn	모델
模式	mó shì	방법
模型	mó xíng	모델
磨合	mó hé	런인
膜	mó	막
魔鬼	mó guǐ	악마
魔术	mó shù	마법
抹杀	mǒ shā	말살
墨水儿	mò shuǐ r	잉크
莫名其妙	mò míng qí miào	이해할 수 없는
默默	mò mò	아무 말 않고
谋求	móu qiú	찾다. 목표물 탐색
模样	mú yàng	외관
母语	mǔ yǔ	모국어
沐浴	mù yù	미역
目睹	mù dǔ	증거
目光	mù guāng	보기
拿手	ná shǒu	좋은
纳闷儿	nà mèn r	궁금해
耐用	nài yòng	튼튼한
南辕北辙	nán yuán běi zhé	다른
难得	nán dé	드문
难堪	nán kān	어리둥절한
难能可贵	nán néng kě guì	칭찬할만한
恼火	nǎo huǒ	괴로운
内涵	nèi hán	내포
内幕	nèi mù	내부 이야기
内在	nèi zài	안의
能量	néng liàng	에너지
拟定	nǐ dìng	작성하다
逆行	nì xíng	역행
年度	nián dù	년
捏	niē	꼬집기
凝固	níng gù	응고
凝聚	níng jù	응집력
凝视	níng shì	응시하다
拧	níng	나사
宁肯	nìng kěn	차라리
宁愿	nìng yuàn	차라리
扭转	niǔ zhuǎn	트위스트
纽扣儿	niǔ kòu r	버튼
农历	nóng lì	음력
浓厚	nóng hòu	강한
奴隶	nú lì	노예
挪	nuó	움직임
虐待	nvè dài	남용
哦	ò	오
殴打	ōu dǎ	박자
偶像	ǒu xiàng	우상
呕吐	ǒu tù	구토
趴	pā	거짓말
徘徊	pái huái	방랑
排斥	pái chì	격퇴
排除	pái chú	들어오지 못하게 하다
排放	pái fàng	방사
排练	pái liàn	연습하다
派别	pài bié	파벌
派遣	pài qiǎn	보내다
攀登	pān dēng	등반
盘旋	pán xuán	돌기
判决	pàn jué	심판
畔	pàn	은행
庞大	páng dà	거대한
抛弃	pāo qì	버리다
泡沫	pào mò	거품
培育	péi yù	양육
配备	pèi bèi	갖추어 준
配偶	pèi ǒu	배우자
配套	pèi tào	어울리는
盆地	pén dì	분지
烹饪	pēng rèn	조리
捧	pěng	보류
劈	pī	마구 자르기
批发	pī fā	모조리
批判	pī pàn	비판
疲惫	pí bèi	지친
疲倦	pí juàn	피곤한
皮革	pí gé	가죽
屁股	pì gu	대상
譬如	pì rú	예를 들면
偏差	piān chā	일탈
偏见	piān jiàn	편견
偏僻	piān pì	먼
偏偏	piān piān	반대로
片断	piàn duàn	파편
片刻	piàn kè	순간
漂浮	piāo fú	흙손
飘扬	piāo yáng	실룩 거리다
撇	piē	스키밍
拼搏	pīn bó	힘든 일
拼命	pīn mìng	필사적으로
贫乏	pín fá	가난한
贫困	pín kùn	가난한
频繁	pín fán	자주
频率	pín lv4	회수
品尝	pǐn cháng	맛이 나다
品德	pǐn dé	캐릭터
品质	pǐn zhì	품질
品种	pǐn zhǒng	종류
屏幕	píng mù	화면
屏障	píng zhàng	장벽
平凡	píng fán	보통주
平面	píng miàn	플랫
平坦	píng tǎn	플랫
平行	píng xíng	평행
平庸	píng yōng	평범한
平原	píng yuán	평원
评估	píng gū	평가
评论	píng lùn	논평
坡	pō	경사
泼	pō	튀김
颇	pō	아주
破例	pò lì	예외 만들기
迫不及待	pò bù jí dài	기다릴 수 없어
迫害	pò hài	박해
魄力	pò lì	용기
扑	pū	실룩 거리다
铺	pū	가게
普及	pǔ jí	만능인
朴实	pǔ shí	단순한
朴素	pǔ sù	단순한
瀑布	pù bù	폭포
凄凉	qī liáng	황량한
期望	qī wàng	배고 있다
期限	qī xiàn	용어
欺负	qī fu	약한 자를 괴롭히는 사람
欺骗	qī piàn	속이다
奇妙	qí miào	훌륭한
旗袍	qí páo	치파오
旗帜	qí zhì	배너
歧视	qí shì	차별
齐全	qí quán	완전한
齐心协力	qí xīn xié lì	협력
乞丐	qǐ gài	거지
企图	qǐ tú	시도
启程	qǐ chéng	출발
启蒙	qǐ méng	계발
启事	qǐ shì	주의
启示	qǐ shì	계발
岂有此理	qǐ yǒu cǐ lǐ	무모한
起草	qǐ cǎo	제도
起初	qǐ chū	처음에
起伏	qǐ fú	기복
起哄	qǐ hòng	부잉
起码	qǐ mǎ	적어도
起源	qǐ yuán	유래
器材	qì cái	장비
器官	qì guān	오르간
气概	qì gài	정신
气功	qì gōng	기공
气魄	qì pò	굵게
气色	qì sè	안색
气势	qì shì	기세
气味	qì wèi	냄새
气象	qì xiàng	기상
气压	qì yā	기압
气质	qì zhí	기질
迄今为止	qì jīn wéi zhǐ	지금까지
掐	qiā	꼬집기
恰当	qià dàng	적당한
恰到好处	qià dào hǎo chù	바로
恰巧	qià qiǎo	우연히
洽谈	qià tán	협상
千方百计	qiān fāng bǎi jì	가능한 모든 것을하십시오
牵	qiān	리드
牵扯	qiān chě	감다
牵制	qiān zhì	있다
签署	qiān shǔ	기호
谦逊	qiān xùn	겸손한
迁就	qiān jiù	수용하다
迁徙	qiān xǐ	이주
前景	qián jǐng	전망
前提	qián tí	전제
潜力	qián lì	가능성
潜水	qián shuǐ	다이빙
潜移默化	qián yí mò huà	눈에 띄지 않게
谴责	qiǎn zé	비난하다
抢劫	qiāng jié	강도
强制	qiáng zhì	필수
强迫	qiǎng pò	힘
抢救	qiǎng jiù	구출
桥梁	qiáo liáng	다리
窍门	qiào mén	장난
翘	qiào	앨리스
切实	qiè shí	실용적인
锲而不舍	qiè ér bù shě	인내
亲密	qīn mì	닫기
亲热	qīn rè	다정한
侵犯	qīn fàn	위반
侵略	qīn lvè	침략
钦佩	qīn pèi	감탄
勤俭	qín jiǎn	열심히 일하는
勤劳	qín láo	부지런한
倾听	qīng tīng	들리다
倾向	qīng xiàng	경향
倾斜	qīng xié	경사
清澈	qīng chè	맑은
清晨	qīng chén	이른 아침
清除	qīng chú	맑은
清洁	qīng jié	깨끗한
清理	qīng lǐ	정리
清晰	qīng xī	맑은
清醒	qīng xǐng	크게 깨어
清真	qīng zhēn	이슬람교도
情报	qíng bào	지성
情节	qíng jié	음모
情理	qíng lǐ	감각
情形	qíng xíng	상태
晴朗	qíng lǎng	햇볕이 잘 드는
请柬	qǐng jiǎn	초대
请教	qǐng jiào	찾다
请示	qǐng shì	지침 요청
请帖	qǐng tiě	초대
丘陵	qiū líng	언덕
区分	qū fēn	드러내다
区域	qū yù	지역
屈服	qū fú	수율
曲折	qū zhé	비뚤어진
驱逐	qū zhú	내쫓다
渠道	qú dào	채널
取缔	qǔ dì	반
曲子	qǔ zi	노래
趣味	qù wèi	맛이 나다
圈套	quān tào	덫
全局	quán jú	글로벌
全力以赴	quán lì yǐ fù	모두 나가
拳头	quán tou	주먹
权衡	quán héng	거래
权威	quán wēi	권위
犬	quǎn	개
缺口	quē kǒu	갭
缺席	quē xí	부재
缺陷	quē xiàn	결함
瘸	qué	절름발이
确保	què bǎo	확인
确立	què lì	세우다
确切	què qiè	정확한
确信	què xìn	확신
群众	qún zhòng	대중
染	rǎn	물든 색
嚷	rǎng	외침
让步	ràng bù	양보
饶恕	ráo shù	용서하다
扰乱	rǎo luàn	방해하다
惹祸	rě huò	법원 재난
热泪盈眶	rè lèi yíng kuàng	눈의 눈물
热门	rè mén	인기 있는
人道	rén dào	인도적인
人格	rén gé	인격
人工	rén gōng	인공
人家	rén jia	사람들
人间	rén jiān	세계
人士	rén shì	사람
人为	rén wéi	인공
人性	rén xìng	인간성
人质	rén zhì	인질
仁慈	rén cí	친절
忍耐	rěn nài	인내
忍受	rěn shòu	견디다
任命	rèn mìng	약속
任性	rèn xìng	변덕스러운
任意	rèn yì	임의
任重道远	rèn zhòng dào yuǎn	갈 길이 멀다
认定	rèn dìng	인식하다
认可	rèn kě	인정
仍旧	réng jiù	아직도
日新月异	rì xīn yuè yì	지나가는 날마다 변화
日益	rì yì	더욱 더
容貌	róng mào	외관
容纳	róng nà	수용하다
容器	róng qì	컨테이너
容忍	róng rěn	참다
溶解	róng jiě	디졸브
荣幸	róng xìng	기꺼이
荣誉	róng yù	명예
融化	róng huà	용해
融洽	róng qià	일치
揉	róu	장애
柔和	róu hé	부드러운
儒家	rú jiā	유도
弱点	ruò diǎn	약점
若干	ruò gān	몇몇의
撒谎	sā huǎng	거짓말
散文	sǎn wén	산문
散布	sàn bù	확산
散发	sàn fā	배포
丧失	sàng shī	잃다
骚扰	sāo rǎo	괴롭히다
嫂子	sǎo zi	시누이
刹车	shā chē	브레이크
啥	shá	뭐
筛选	shāi xuǎn	필터
山脉	shān mài	산
闪烁	shǎn shuò	섬광
擅长	shàn cháng	잘
擅自	shàn zì	무단
伤脑筋	shāng nǎo jīn	귀찮은
商标	shāng biāo	등록 상표
上级	shàng jí	우수한
上进	shàng jìn	동기 부여
上任	shàng rèn	취임
上瘾	shàng yǐn	중독
上游	shàng yóu	업스트림
尚且	shàng qiě	아직도
捎	shāo	따라 가다
梢	shāo	팁
哨	shào	게시하다
奢侈	shē chǐ	사치
舌头	shé tou	혀
摄氏度	shè shì dù	섭씨
涉及	shè jí	뒤얽힌
社区	shè qū	커뮤니티
设立	shè lì	설정
设想	shè xiǎng	상상
设置	shè zhì	설정
呻吟	shēn yín	신음 소리
深奥	shēn ào	깊은
深沉	shēn chén	깊은
深情厚谊	shēn qíng hòu yì	깊은 우정
申报	shēn bào	알리다
绅士	shēn shì	신사
神经	shén jīng	신경 이상
神奇	shén qí	마법 같은
神气	shén qì	공기
神圣	shén shèng	신성한
神态	shén tài	행실
神仙	shén xiān	불멸
审查	shěn chá	리뷰
审理	shěn lǐ	시도
审美	shěn měi	미적
审判	shěn pàn	시도
慎重	shèn zhòng	꼼꼼한
渗透	shèn tòu	침투
声明	shēng míng	성명서
声势	shēng shì	기세
声誉	shēng yù	평판
牲畜	shēng chù	가축
生存	shēng cún	살아남 다
生机	shēng jī	활력
生理	shēng lǐ	생리 학적
生疏	shēng shū	녹슨
生态	shēng tài	생태학
生物	shēng wù	생물학적
生效	shēng xiào	효과
生肖	shēng xiào	황도 십이궁
生锈	shēng xiù	녹
生育	shēng yù	비옥
省会	shěng huì	지방 수도
盛产	shèng chǎn	풍부한
盛开	shèng kāi	꽃
盛情	shèng qíng	환대
盛行	shèng xíng	흐르다
胜负	shèng fù	이기거나 지거나
失事	shī shì	난파선
失误	shī wù	잘못
失踪	shī zōng	잃어버린
尸体	shī tǐ	시체
师范	shī fàn	선생님
施加	shī jiā	두다
施展	shī zhǎn	디스플레이
十足	shí zú	완전한
实惠	shí huì	저렴한
实力	shí lì	힘
实施	shí shī	도구
实事求是	shí shì qiú shì	사실에서 진실을 찾아라
实行	shí xíng	도구
实质	shí zhì	물질
拾	shí	픽업
时常	shí cháng	자주
时而	shí ér	때때로
时光	shí guāng	시각
时机	shí jī	기회
时事	shí shì	현재 이벤트
石油	shí yóu	기름
识别	shí bié	식별
使命	shǐ mìng	사명
世代	shì dài	세대
事故	shì gù	사고
事迹	shì jì	행위
事件	shì jiàn	행사
事态	shì tài	상태
事务	shì wù	사무
事项	shì xiàng	문제
事业	shì yè	원인
势必	shì bì	하게되다
势力	shì li	힘
是非	shì fēi	옳고 그름
示范	shì fàn	데모
示威	shì wēi	데모
示意	shì yì	신호
视力	shì lì	전망
视频	shì pín	비디오
视线	shì xiàn	시각
视野	shì yě	전망
试图	shì tú	시도
试验	shì yàn	테스트
适宜	shì yí	적당한
逝世	shì shì	멀리
释放	shì fàng	해방
收藏	shōu cáng	즐겨 찾기
收缩	shōu suō	수축
收益	shōu yì	수입
收音机	shōu yīn jī	라디오
守护	shǒu hù	가드
手法	shǒu fǎ	기술
手势	shǒu shì	몸짓
手艺	shǒu yì	선박
首饰	shǒu shì	보석류
首要	shǒu yào	일 순위
受罪	shòu zuì	참다
授予	shòu yǔ	부여
书法	shū fǎ	달필
书记	shū ji	비서
书籍	shū jí	서적
书面	shū miàn	쓴
疏忽	shū hu	과실
疏远	shū yuǎn	외계인
舒畅	shū chàng	편안
数额	shù é	양
束	shù	묶음
束缚	shù fù	속박
树立	shù lì	설정
竖	shù	세로
耍	shuǎ	플레이
衰老	shuāi lǎo	노화
衰退	shuāi tuì	쇠퇴
率领	shuài lǐng	리드
涮火锅	shuàn huǒ guō	샤브샤브
双胞胎	shuāng bāo tāi	쌍
爽快	shuǎng kuài	손쉽게
水利	shuǐ lì	물 절약
水龙头	shuǐ lóng tóu	수도꼭지
水泥	shuǐ ní	시멘트
瞬间	shùn jiān	순간
司法	sī fǎ	사법
司令	sī lìng	사령관
思念	sī niàn	미스...
思索	sī suǒ	생각
思维	sī wéi	생각
斯文	sī wen	부드러운
私自	sī zì	몰래
死亡	sǐ wáng	죽음
四肢	sì zhī	사지
寺庙	sì miào	신전
肆无忌惮	sì wú jì dàn	사악한
饲养	sì yǎng	양육
耸	sǒng	높이 솟은
艘	sōu	배
苏醒	sū xǐng	일어나 다
俗话	sú huà	속어
塑造	sù zào	모양
素食	sù shí	채식주의 자 음식
素质	sù zhì	품질
诉讼	sù sòng	소송
算数	suàn shù	카운트
随即	suí jí	바로
随意	suí yì	무작위
岁月	suì yuè	연령
隧道	suì dào	터널
损坏	sǔn huài	피해를 주다
索取	suǒ qǔ	의뢰
索性	suǒ xìng	간단히
塌	tā	무너짐
踏实	tā shi	견고 함
塔	tǎ	탑
台风	tái fēng	태풍
太空	tài kōng	우주
泰斗	tài dǒu	학장
摊	tān	마구간
瘫痪	tān huàn	마비
贪婪	tān lán	탐욕스러운
贪污	tān wū	부패
弹性	tán xìng	탄력
坦白	tǎn bái	솔직한
叹气	tàn qì	한숨
探测	tàn cè	감지
探索	tàn suǒ	탐험하다
探讨	tàn tǎo	탐색
探望	tàn wàng	방문
倘若	tǎng ruò	만약
掏	tāo	파기
滔滔不绝	tāo tāo bù jué	끝없이 이야기
淘汰	táo tài	제거됨
陶瓷	táo cí	세라믹
陶醉	táo zuì	술잔치
讨好	tǎo hǎo	부디
特长	tè cháng	전문
特定	tè dìng	특유한
特意	tè yì	특별히
提拔	tí bá	승진
提炼	tí liàn	정제
提示	tí shì	신속한
提议	tí yì	신청
题材	tí cái	테마
体裁	tǐ cái	유형
体积	tǐ jī	음량
体谅	tǐ liàng	사려 깊은
体面	tǐ miàn	어지간한
体系	tǐ xì	체계
天才	tiān cái	천재
天赋	tiān fù	재능
天伦之乐	tiān lún zhī lè	가족의 즐거움
天然气	tiān rán qì	천연 가스
天生	tiān shēng	태어난
天堂	tiān táng	천국
天文	tiān wén	천문학적 인
田径	tián jìng	육상 경기
田野	tián yě	들
舔	tiǎn	핥기
挑剔	tiāo ti	까다로운
条款	tiáo kuǎn	자귀
条理	tiáo lǐ	조직
条约	tiáo yuē	조약
调和	tiáo hé	화해하다
调剂	tiáo jì	맞추다
调节	tiáo jié	맞추다
调解	tiáo jiě	중개
调料	tiáo liào	양념
挑拨	tiǎo bō	놀다
挑衅	tiǎo xìn	성나게 하는
跳跃	tiào yuè	도약
亭子	tíng zi	누각
停泊	tíng bó	주차
停顿	tíng dùn	중지
停滞	tíng zhì	흐르지 않는
挺拔	tǐng bá	크고 똑바로
通货膨胀	tōng huò péng zhàng	인플레이션
通缉	tōng jī	원했다
通俗	tōng sú	인기 있는
通讯	tōng xùn	통신
通用	tōng yòng	만능인
同胞	tóng bāo	형제
同志	tóng zhì	게이
童话	tóng huà	동화
铜	tóng	구리
统筹兼顾	tǒng chóu jiān gù	전반적인 계획
统计	tǒng jì	통계
统统	tǒng tǒng	모두
统治	tǒng zhì	규칙
投机	tóu jī	추측
投票	tóu piào	투표
投诉	tóu sù	불평
投降	tóu xiáng	항복
投掷	tóu zhì	던지다
透露	tòu lù	드러내다
秃	tū	노골적인
突破	tū pò	돌파구
图案	tú àn	무늬
徒弟	tú dì	도제
涂抹	tú mǒ	도말 표본
途径	tú jìng	방법
土壤	tǔ rǎng	흙
团结	tuán jié	단일성
团体	tuán tǐ	그룹
团圆	tuán yuán	재결합
推测	tuī cè	추측
推翻	tuī fān	타도
推理	tuī lǐ	추리
推论	tuī lùn	추론
推销	tuī xiāo	팔다
吞吞吐吐	tūn tūn tǔ tǔ	망설임
托运	tuō yùn	위탁
拖延	tuō yán	미루는 것
脱离	tuō lí	이탈
妥当	tuǒ dang	적당한
妥善	tuǒ shàn	적절한
妥协	tuǒ xié	타협
椭圆	tuǒ yuán	타원
唾弃	tuò qì	버리다
哇	wa	와
挖掘	wā jué	파기
娃娃	wá wa	인형
瓦解	wǎ jiě	무너짐
歪曲	wāi qū	왜곡하다
外表	wài biǎo	외관
外行	wài háng	평신도
外界	wài jiè	외부 세계
外向	wài xiàng	나가는
丸	wán	알약
完备	wán bèi	완전한
完毕	wán bì	완전한
玩弄	wán nòng	플레이
玩意儿	wán yì r	맡은 일
顽固	wán gù	완고한
顽强	wán qiáng	끈기 있는
惋惜	wǎn xī	유감
挽回	wǎn huí	도로 사다
挽救	wǎn jiù	저장
万分	wàn fēn	매우
往常	wǎng cháng	평소처럼
往事	wǎng shì	과거
妄想	wàng xiǎng	미혹
危机	wēi jī	위기
威风	wēi fēng	명성
威力	wēi lì	힘
威望	wēi wàng	명성
威信	wēi xìn	명성
微不足道	wēi bù zú dào	무시할 수있는
微观	wēi guān	마이크로
为难	wéi nán	어리둥절한
为期	wéi qī	지속
唯独	wéi dú	혼자
维持	wéi chí	유지하다
维护	wéi hù	유지하다
维生素	wéi shēng sù	비타민
违背	wéi bèi	반대하다
伪造	wěi zào	위조
委托	wěi tuō	위원회
委员	wěi yuán	위원회 위원
卫星	wèi xīng	위성
喂	wèi	안녕하세요 (동사)
慰问	wèi wèn	애도
未免	wèi miǎn	피할 수 없는
畏惧	wèi jù	무서움
蔚蓝	wèi lán	하늘빛
温带	wēn dài	온대
温和	wēn hé	경증
文凭	wén píng	졸업 증서
文物	wén wù	문화 유물
文献	wén xiàn	문학
文雅	wén yǎ	우아한
文艺	wén yì	미술
问世	wèn shì	나오다
窝	wō	둥지
乌黑	wū hēi	흑 옥색
污蔑	wū miè	중상
诬陷	wū xiàn	틀
无比	wú bǐ	매우
无偿	wú cháng	비어 있는
无耻	wú chǐ	뻔뻔한
无动于衷	wú dòng yú zhōng	무관심한
无非	wú fēi	더 이상
无辜	wú gū	순진한
无精打采	wú jīng dǎ cǎi	노곤한
无赖	wú lài	도적
无理取闹	wú lǐ qǔ nào	무모한
无能为力	wú néng wéi lì	무력
无穷无尽	wú qióng wú jìn	끝없는
无微不至	wú wēi bù zhì	세심한
无忧无虑	wú yōu wú lv4	평온한
无知	wú zhī	무지
侮辱	wǔ rǔ	모욕
武器	wǔ qì	무기
武侠	wǔ xiá	무술
武装	wǔ zhuāng	무장
舞蹈	wǔ dǎo	댄스
务必	wù bì	확실히하다
物美价廉	wù měi jià lián	좋은 품질과 저렴한
物业	wù yè	특성
物资	wù zī	용품
误差	wù chā	오류
误解	wù jiě	오해
夕阳	xī yáng	일몰
昔日	xī rì	옛날
溪	xī	작은 만
熄灭	xī miè	나가
牺牲	xī shēng	희생
膝盖	xī gài	무릎
习俗	xí sú	커스텀
媳妇	xí fu	법의 딸
袭击	xí jī	폭행
喜闻乐见	xǐ wén lè jiàn	듣고 싶어
喜悦	xǐ yuè	즐거움
系列	xì liè	시리즈
细菌	xì jūn	세균
细胞	xì bāo	세포
细致	xì zhì	세심한
峡谷	xiá gǔ	깊은 협곡
狭隘	xiá ài	제한된
狭窄	xiá zhǎi	제한된
霞	xiá	xia
下属	xià shǔ	부하
先进	xiān jìn	많은
先前	xiān qián	이전에
掀起	xiān qǐ	출발하다
纤维	xiān wéi	섬유
鲜明	xiān míng	선명한
嫌	xián	싫어함
嫌疑	xián yí	용의자
弦	xián	끈
衔接	xián jiē	연결
贤惠	xián huì	덕 있는
闲话	xián huà	잡담
显著	xiǎn zhù	중요한
宪法	xiàn fǎ	헌법
现场	xiàn chǎng	현장
现成	xiàn chéng	기성품
现状	xiàn zhuàng	현상 유지
线索	xiàn suǒ	실마리
陷害	xiàn hài	액자
陷阱	xiàn jǐng	덫
陷入	xiàn rù	빠지다
馅儿	xiàn r	소
乡镇	xiāng zhèn	타운십
相差	xiāng chà	차
相等	xiāng děng	같은
相辅相成	xiāng fǔ xiāng chéng	서로 보완
相应	xiāng yìng	동
镶嵌	xiāng qiàn	모자이크
响亮	xiǎng liàng	화려한
响应	xiǎng yìng	응답
想方设法	xiǎng fāng shè fǎ	방법 찾기
向导	xiàng dǎo	안내서
向来	xiàng lái	항상
向往	xiàng wǎng	그리워하다
巷	xiàng	레인
相声	xiàng sheng	누화
消除	xiāo chú	죽이다
消毒	xiāo dú	소독하다
消防	xiāo fáng	소방
消耗	xiāo hào	바싹 여위다
消灭	xiāo miè	닦아내 다
潇洒	xiāo sǎ	우아한
销毁	xiāo huǐ	멸하다
小心翼翼	xiǎo xīn yì yì	조심성 있게
效益	xiào yì	이익
肖像	xiào xiàng	초상화
协会	xié huì	협회
协商	xié shāng	협상
协调	xié tiáo	동등
协议	xié yì	실험 계획안
协助	xié zhù	돕다
携带	xié dài	나르다
屑	xiè	부스러기
泄露	xiè lù	방법을 제공
泄气	xiè qì	낙담
谢绝	xiè jué	쇠퇴
心得	xīn dé	경험
心甘情愿	xīn gān qíng yuàn	기꺼이
心灵	xīn líng	영혼
心态	xīn tài	심리
心疼	xīn téng	고민
心血	xīn xuè	힘든 일
心眼儿	xīn yǎn r	마음 챙김
新陈代谢	xīn chén dài xiè	대사
新郎	xīn láng	신랑
新娘	xīn niáng	신부
新颖	xīn yǐng	소설
欣慰	xīn wèi	만족
欣欣向荣	xīn xīn xiàng róng	번성
薪水	xīn shuǐ	봉급
辛勤	xīn qín	힘든 일
信赖	xìn lài	믿음
信念	xìn niàn	믿음
信仰	xìn yǎng	신앙
信誉	xìn yù	평판
兴高采烈	xīng gāo cǎi liè	의기 양양한
兴隆	xīng lóng	번영
兴旺	xīng wàng	번성
腥	xīng	수상한
刑事	xíng shì	범죄자
形态	xíng tài	형태
行政	xíng zhèng	행정
兴致勃勃	xìng zhì bó bó	흥분한
性感	xìng gǎn	섹시한
性命	xìng mìng	생명
性能	xìng néng	공연
凶恶	xiōng è	나쁜
凶手	xiōng shǒu	살인자
汹涌	xiōng yǒng	난류
胸怀	xiōng huái	마음
胸膛	xiōng táng	가슴
雄厚	xióng hòu	강한
雄伟	xióng wěi	위엄 있는
修复	xiū fù	수리
修建	xiū jiàn	짓다
修养	xiū yǎng	훈련
羞耻	xiū chǐ	부끄러움
嗅觉	xiù jué	냄새
绣	xiù	수놓다
虚假	xū jiǎ	그릇된
虚荣	xū róng	화장대
虚伪	xū wěi	위선적 인
需求	xū qiú	수요
须知	xū zhī	주의
许可	xǔ kě	특허
序言	xù yán	머리말
畜牧	xù mù	축산
酗酒	xù jiǔ	대주
喧哗	xuān huá	소란
宣誓	xuān shì	맹세하다
宣扬	xuān yáng	설교
悬挂	xuán guà	현탁
悬念	xuán niàn	미결
悬殊	xuán shū	상이
悬崖峭壁	xuán yá qiào bì	절벽
旋律	xuán lv4	멜로디
旋转	xuán zhuǎn	회전
选拔	xuǎn bá	선택
选举	xuǎn jǔ	선거
选手	xuǎn shǒu	플레이어
炫耀	xuàn yào	보여
削	xuē	절단
削弱	xuē ruò	묽게 하다
学说	xué shuō	이론
学位	xué wèi	과학 학사
雪上加霜	xuě shàng jiā shuāng	보다 나쁜
血压	xuè yā	혈압
熏陶	xūn táo	edify
寻觅	xún mì	찾기
巡逻	xún luó	순찰
循环	xún huán	주기
循序渐进	xún xù jiàn jìn	단계적으로
压迫	yā pò	압박
压岁钱	yā suì qián	새해 돈
压缩	yā suō	압축
压抑	yā yì	우울함
压榨	yā zhà	프레스
压制	yā zhì	막다
鸦雀无声	yā què wú shēng	조용한
亚军	yà jūn	준우승
淹没	yān mò	잠수함
烟花爆竹	yān huā bào zhú	폭죽
严峻	yán jùn	중증
严寒	yán hán	심한 감기
严禁	yán jìn	엄격하게 금지 된
严厉	yán lì	중증
严密	yán mì	빠듯한
岩石	yán shí	록
延期	yán qī	신장
延伸	yán shēn	넓히다
延续	yán xù	계속하다
沿海	yán hǎi	연안의
炎热	yán rè	뜨거운
言论	yán lùn	연설
掩盖	yǎn gài	덮개
掩护	yǎn hù	덮개
掩饰	yǎn shì	은폐하다
演变	yǎn biàn	진화
演习	yǎn xí	운동
演绎	yǎn yì	공제
演奏	yǎn zòu	놀이
眼光	yǎn guāng	전망
眼色	yǎn sè	눈짓
眼神	yǎn shén	보기
厌恶	yàn wù	싫음
验收	yàn shōu	수락
验证	yàn zhèng	확인
氧气	yǎng qì	산소
样品	yàng pǐn	견본
摇摆	yáo bǎi	그네
摇滚	yáo gǔn	록
谣言	yáo yán	소문
遥控	yáo kòng	리모콘
遥远	yáo yuǎn	먼
耀眼	yào yǎn	눈부신
要点	yào diǎn	포인트
要命	yào mìng	무서운
要素	yào sù	요소
野蛮	yě mán	잔인한
野心	yě xīn	큰 뜻
液体	yè tǐ	액체
一流	yī liú	최상위
一如既往	yī rú jì wǎng	언제나처럼
依旧	yī jiù	아직도
依据	yī jù	에 따라
依靠	yī kào	의지하다
依赖	yī lài	의지하다
依托	yī tuō	의지
衣裳	yī shang	천
一度	yí dù	한 번
一贯	yí guàn	일관된
一目了然	yí mù liǎo rán	한눈에
一向	yí xiàng	항상
仪器	yí qì	악기
仪式	yí shì	의식
疑惑	yí huò	의심
遗产	yí chǎn	세습 재산
遗传	yí chuán	유전
遗留	yí liú	유산
遗失	yí shī	잃어버린
以便	yǐ biàn	그래서
以免	yǐ miǎn	하지 않도록
以往	yǐ wǎng	과거에
以至	yǐ zhì	조차
以致	yǐ zhì	그래서
一帆风顺	yì fān fēng shùn	부드러운 항해
一举两得	yì jǔ liǎng dé	하나의 돌로 두 마리의 새를 죽이십시오
一丝不苟	yì sī bù gǒu	세심한
亦	yì	또한
异常	yì cháng	이상
意料	yì liào	예상
意识	yì shí	인식
意图	yì tú	의향
意味着	yì wèi zhe	평균
意向	yì xiàng	의향
意志	yì zhì	의지
毅力	yì lì	인내
毅然	yì rán	단호히
翼	yì	날개
阴谋	yīn móu	음모
音响	yīn xiǎng	소리
引导	yǐn dǎo	안내서
引擎	yǐn qíng	엔진
引用	yǐn yòng	인용문
隐蔽	yǐn bì	숨겨진
隐患	yǐn huàn	숨겨진 위험
隐瞒	yǐn mán	숨는 장소
隐私	yǐn sī	은둔
隐约	yǐn yuē	희미한
饮食	yǐn shí	다이어트
婴儿	yīng ér	아가
英明	yīng míng	슬기로운
英勇	yīng yǒng	과장된 어조
盈利	yíng lì	이익
迎面	yíng miàn	머리에
应酬	yìng chou	사회화
应邀	yìng yāo	초대 받기
庸俗	yōng sú	저속한
拥护	yōng hù	지원하다
拥有	yōng yǒu	있다
勇于	yǒng yú	용감한
永恒	yǒng héng	영원한
涌现	yǒng xiàn	나타나다
踊跃	yǒng yuè	적극적으로
用户	yòng hù	사용자
优胜劣汰	yōu shèng liè tài	적자 생존
优先	yōu xiān	우선 순위
优异	yōu yì	우수한
优越	yōu yuè	우수한
忧郁	yōu yù	우울
油腻	yóu nì	기름 바른
油漆	yóu qī	페인트
犹如	yóu rú	마치
有条不紊	yǒu tiáo bù wěn	질서 있는
幼稚	yòu zhì	소박한
诱惑	yòu huò	유혹 안에서
愚蠢	yú chǔn	바보
愚昧	yú mèi	무지
渔民	yú mín	어민
舆论	yú lùn	여론
与日俱增	yǔ rì jù zēng	날마다 증가
宇宙	yǔ zhòu	우주
羽绒服	yǔ róng fú	다운 재킷
寓言	yù yán	우화
愈	yù	고치다
欲望	yù wàng	염원
熨	yù	다리미질
玉	yù	옥
预料	yù liào	예상
预期	yù qī	예상
预算	yù suàn	예산
预先	yù xiān	전진
预言	yù yán	예언
预兆	yù zhào	전조
冤枉	yuān wang	잘못됨
元首	yuán shǒu	국가 원수
元素	yuán sù	요소
元宵节	yuán xiāo jié	등불 축제
原告	yuán gào	원고
原理	yuán lǐ	원리
原始	yuán shǐ	실물
原先	yuán xiān	실물
园林	yuán lín	정원
圆满	yuán mǎn	완전한
源泉	yuán quán	출처
缘故	yuán gù	이유
约束	yuē shù	강제
乐谱	yuè pǔ	망할 음악
岳母	yuè mǔ	장모
孕育	yùn yù	번식
蕴藏	yùn cáng	있다
运算	yùn suàn	계산
运行	yùn xíng	운영
酝酿	yùn niàng	양조
杂技	zá jì	재주 넘기
杂交	zá jiāo	이종 교잡
砸	zá	스매시
咋	zǎ	어떻게
栽培	zāi péi	경작
灾难	zāi nàn	재앙
宰	zǎi	학살
再接再厉	zài jiē zài lì	끈질 기게 노력하다
在意	zài yì	케어
攒	zǎn	저장
暂且	zàn qiě	당분간
赞叹	zàn tàn	감탄
赞助	zàn zhù	스폰서
糟蹋	zāo tà	약탈
遭受	zāo shòu	참다
遭殃	zāo yāng	참다
遭遇	zāo yù	교전
噪音	zào yīn	소음
造型	zào xíng	모델링
责怪	zé guài	비난
贼	zéi	도둑
增添	zēng tiān	더하다
赠送	zèng sòng	포기
扎	zhā	넥타이
扎实	zhā shi	고체
渣	zhā	광재
眨	zhǎ	힐끔 보다
诈骗	zhà piàn	사기
摘要	zhāi yào	요약
债券	zhài quàn	노예
沾光	zhān guāng	담그다
瞻仰	zhān yǎng	경의를 표하다
展示	zhǎn shì	보여
展望	zhǎn wàng	시야
展现	zhǎn xiàn	보여
崭新	zhǎn xīn	아주 새로운
斩钉截铁	zhǎn dīng jié tiě	결정적으로
占据	zhàn jù	차지하다
占领	zhàn lǐng	가득차 있는
战斗	zhàn dòu	싸움
战略	zhàn lvè	전략
战术	zhàn shù	전술
战役	zhàn yì	전투
章程	zhāng chéng	전세
帐篷	zhàng peng	텐트
障碍	zhàng ài	장애물
招标	zhāo biāo	입찰
招收	zhāo shōu	모집하다
朝气蓬勃	zhāo qì péng bó	원기 왕성한
着迷	zháo mí	매혹
沼泽	zhǎo zé	늪
照样	zhào yàng	아직도
照耀	zhào yào	광택
折腾	zhē teng	던져 올림
遮挡	zhē dǎng	막다
折	zhé	겹
折磨	zhé mó	고문
侦探	zhēn tàn	형사
斟酌	zhēn zhuó	중히 여기다
珍贵	zhēn guì	귀한
珍稀	zhēn xī	드문
珍珠	zhēn zhū	진주
真理	zhēn lǐ	진실
真相	zhēn xiàng	진실
真挚	zhēn zhì	성실한
枕头	zhěn tou	베개
振奋	zhèn fèn	융기
振兴	zhèn xīng	활성화
镇定	zhèn dìng	고요한
镇静	zhèn jìng	고요한
阵地	zhèn dì	위치
阵容	zhèn róng	라인업
震撼	zhèn hàn	충격
震惊	zhèn jīng	충격
争端	zhēng duān	분쟁
争夺	zhēng duó	투쟁
争气	zhēng qì	승리
争先恐后	zhēng xiān kǒng hòu	스크램블
争议	zhēng yì	분쟁
征服	zhēng fú	정복하다
征收	zhēng shōu	수집
挣扎	zhēng zhá	노력
正月	zhēng yuè	첫 달
蒸发	zhēng fā	증발
整顿	zhěng dùn	수정
政策	zhèng cè	수단
政权	zhèng quán	제도
正当	zhèng dāng	양쪽 맞춤
正负	zhèng fù	긍정과 부정
正规	zhèng guī	정규병
正经	zhèng jing	진지한
正气	zhèng qì	정당성
正义	zhèng yì	정의
正宗	zhèng zōng	진정한
症状	zhèng zhuàng	징후
证实	zhèng shí	확인
证书	zhèng shū	증명서
郑重	zhèng zhòng	엄숙하게
之际	zhī jì	기회에
支撑	zhī chēng	지원하다
支出	zhī chū	지출
支流	zhī liú	지류
支配	zhī pèi	억누르다
支援	zhī yuán	지원하다
支柱	zhī zhù	기둥
枝	zhī	분기
知觉	zhī jué	지각
知足常乐	zhī zú cháng lè	만족
脂肪	zhī fáng	지방
侄子	zhí zi	조카
值班	zhí bān	근무중인
执行	zhí xíng	수행
执着	zhí zhuó	고집
殖民地	zhí mín dì	식민지
直播	zhí bō	생방송
直径	zhí jìng	직경
职能	zhí néng	함수
职位	zhí wèi	위치
职务	zhí wù	위치
指标	zhǐ biāo	인덱스
指定	zhǐ dìng	지정
指甲	zhǐ jia	손톱
指令	zhǐ lìng	교수
指南针	zhǐ nán zhēn	나침반
指示	zhǐ shì	명령
指望	zhǐ wàng	기대다
指责	zhǐ zé	고발
制裁	zhì cái	제재
制服	zhì fú	제복
制约	zhì yuē	제지
制止	zhì zhǐ	중지
志气	zhì qì	큰 뜻
智力	zhì lì	지성
智能	zhì néng	지적인
智商	zhì shāng	iq
治安	zhì ān	법과 질서
治理	zhì lǐ	통치
滞留	zhì liú	머무르다
致辞	zhì cí	주소
致力	zhì lì	약속
致使	zhì shǐ	원인
中断	zhōng duàn	일시 정지
中立	zhōng lì	중립국
中央	zhōng yāng	본부
忠诚	zhōng chéng	충의
忠实	zhōng shí	충성
终点	zhōng diǎn	종료
终究	zhōng jiū	아무튼
终身	zhōng shēn	평생
终止	zhōng zhǐ	종료
衷心	zhōng xīn	진심으로
种子	zhǒng zi	씨
种族	zhǒng zú	경주
肿瘤	zhǒng liú	종양
众所周知	zhòng suǒ zhōu zhī	잘 알려진
种植	zhòng zhí	심기
重心	zhòng xīn	무게 중심
周边	zhōu biān	주변
周密	zhōu mì	꼼꼼한
周年	zhōu nián	기념일
周期	zhōu qī	주기
周折	zhōu zhé	돌아서 다
周转	zhōu zhuǎn	회전율
州	zhōu	상태
粥	zhōu	오트밀 죽
舟	zhōu	보트
昼夜	zhòu yè	낮과 밤
皱纹	zhòu wén	좋은 생각
株	zhū	변형
诸位	zhū wèi	여러분
逐年	zhú nián	해마다
主办	zhǔ bàn	주최자
主导	zhǔ dǎo	주요한
主管	zhǔ guǎn	감독자
主流	zhǔ liú	주류
主权	zhǔ quán	주권
主义	zhǔ yì	교의
嘱咐	zhǔ fù	간곡히 타이르다
拄	zhǔ	압착
住宅	zhù zhái	주거용
助理	zhù lǐ	대리
助手	zhù shǒu	조수
注射	zhù shè	주입
注视	zhù shì	보다
注释	zhù shì	논평
注重	zhù zhòng	주의
著作	zhù zuò	도서
铸造	zhù zào	주조
驻扎	zhù zhā	주둔
拽	zhuài	견인
专长	zhuān cháng	전문적 지식
专程	zhuān chéng	특별한 여행
专利	zhuān lì	특허
专题	zhuān tí	이야기
砖	zhuān	벽돌
转达	zhuǎn dá	나르다
转让	zhuǎn ràng	이전
转移	zhuǎn yí	이전
转折	zhuǎn zhé	전환점
传记	zhuàn jì	전기
庄稼	zhuāng jià	작물
庄严	zhuāng yán	엄숙한
庄重	zhuāng zhòng	엄숙한
装备	zhuāng bèi	장비
装卸	zhuāng xiè	로드 및 언로드
壮观	zhuàng guān	스펙 타 큘러
壮丽	zhuàng lì	웅장한
壮烈	zhuàng liè	과장된 어조
幢	zhuàng	건물
追悼	zhuī dào	기념물
追究	zhuī jiū	조사하다
坠	zhuì	가을
准则	zhǔn zé	지침
卓越	zhuó yuè	우수
琢磨	zhuó mó	숙고
着手	zhuó shǒu	설정
着想	zhuó xiǎng	위해
着重	zhuó zhòng	초점
姿态	zī tài	태도
滋润	zī rùn	보습
滋味	zī wèi	맛이 나다
资本	zī běn	자본
资产	zī chǎn	자산
资深	zī shēn	연장자
资助	zī zhù	자금
子弹	zǐ dàn	총알
自卑	zì bēi	하위
自发	zì fā	자발적인
自力更生	zì lì gēng shēng	자립
自满	zì mǎn	자기 만족적인
自主	zì zhǔ	자발적인
宗教	zōng jiào	종교
宗旨	zōng zhǐ	목적
棕色	zōng sè	갈색
踪迹	zōng jì	자취
总而言之	zǒng ér yán zhī	전체적으로
总和	zǒng hé	합집합
纵横	zòng héng	수직 및 수평
走廊	zǒu láng	복도
走漏	zǒu lòu	새는 곳
走私	zǒu sī	밀수
揍	zòu	박자
租赁	zū lìn	임차권
足以	zú yǐ	충분한
祖父	zǔ fù	할아버지
祖国	zǔ guó	모국
祖先	zǔ xiān	선조
阻碍	zǔ ài	방해
阻拦	zǔ lán	중지
阻挠	zǔ náo	막다
钻研	zuān yán	탐구
钻石	zuàn shí	다이아몬드
嘴唇	zuǐ chún	입술
罪犯	zuì fàn	범죄자
尊严	zūn yán	존엄
遵循	zūn xún	따르다
作弊	zuò bì	사기
作废	zuò fèi	빈
作风	zuò fēng	스타일
作息	zuò xī	쉬다
做主	zuò zhǔ	샷을 불러
座右铭	zuò yòu míng	금언
