哎	āi	เฮ้
唉	āi	ฮึ
爱护	ài hù	หวงแหน
爱惜	ài xī	หวงแหน
爱心	ài xīn	รัก
安慰	ān wèi	ความสบายใจ
安装	ān zhuāng	การติดตั้ง
岸	àn	ชายฝั่ง
暗	àn	มืด
熬夜	áo yè	ตื่นสาย
把握	bǎ wò	เข้าใจ
摆	bǎi	ใส่
办理	bàn lǐ	ด้ามจับ
傍晚	bàng wǎn	ตอนเย็น
包裹	bāo guǒ	แพ็คเกจ
包含	bāo hán	บรรจุ
包括	bāo kuò	รวม
薄	báo	ผอม
保持	bǎo chí	บำรุงรักษา
保存	bǎo cún	บันทึก
保留	bǎo liú	เก็บ
保险	bǎo xiǎn	ประกันภัย
宝贝	bǎo bèi	ที่รัก
宝贵	bǎo guì	มีค่า
报到	bào dào	เช็คอิน
报道	bào dào	รายงาน
报告	bào gào	รายงาน
报社	bào shè	หนังสือพิมพ์
抱怨	bào yuàn	บ่น
悲观	bēi guān	มองโลกในแง่ร้าย
背	bèi	กลับ
背景	bèi jǐng	พื้นหลัง
被子	bèi zi	ผ้าห่ม
本科	běn kē	ระดับปริญญาตรี
本领	běn lǐng	ความสามารถ
本质	běn zhì	ธรรมชาติ
彼此	bǐ cǐ	กันและกัน
比例	bǐ lì	สัดส่วน
必然	bì rán	หลีกเลี่ยงไม่ได้
必要	bì yào	จำเป็น
毕竟	bì jìng	หลังจากนั้น
避免	bì miǎn	หลีกเลี่ยง
编辑	biān jí	แก้ไข
鞭炮	biān pào	พลุ
便	biàn	คนเซ่อ
辩论	biàn lùn	อภิปราย
标点	biāo diǎn	เครื่องหมายวรรคตอน
标志	biāo zhì	เข้าสู่ระบบ
表达	biǎo dá	การแสดงออก
表面	biǎo miàn	พื้นผิว
表明	biǎo míng	แสดง
表情	biǎo qíng	การแสดงออก
表现	biǎo xiàn	ซึ่งดำเนินการ
冰激凌	bīng jī líng	ไอศครีม
病毒	bìng dú	ไวรัส
播放	bō fàng	เล่น
玻璃	bō li	กระจก
博物馆	bó wù guǎn	พิพิธภัณฑ์
脖子	bó zi	คอ
不断	bú duàn	เก็บไว้ใน
不见得	bú jiàn de	ไม่จำเป็น
不耐烦	bú nài fán	ใจร้อน
不要紧	bú yào jǐn	ไม่เป็นไร
补充	bǔ chōng	เสริม
不安	bù ān	รบกวน
不得了	bù dé liǎo	แย่มาก
不然	bù rán	มิฉะนั้น
不如	bù rú	ไม่ดีเท่า
不足	bù zú	ไม่เพียงพอ
布	bù	ผ้า
步骤	bù zhòu	ขั้นตอน
部门	bù mén	สาขา
财产	cái chǎn	ทรัพย์สิน
彩虹	cǎi hóng	รุ้ง
踩	cǎi	เหยียบย่าง
采访	cǎi fǎng	สัมภาษณ์
采取	cǎi qǔ	รับ
参考	cān kǎo	อ้างอิง
参与	cān yù	มีส่วนร่วม
惭愧	cán kuì	ละอายใจ
操场	cāo chǎng	สนามเด็กเล่น
操心	cāo xīn	กังวล
册	cè	หนังสือ
测验	cè yàn	ทดสอบ
曾经	céng jīng	ครั้งเดียว
叉子	chā zi	ส้อม
差距	chā jù	ช่องว่าง
插	chā	แทรก
拆	chāi	รื้อ
产品	chǎn pǐn	สินค้า
产生	chǎn shēng	ผลิต
常识	cháng shí	กึ๋น
长途	cháng tú	ทางยาว
抄	chāo	สำเนา
超级	chāo jí	สุดยอด
朝	cháo	ต่อ
潮湿	cháo shī	ชื้น
吵	chǎo	เสียงดัง
吵架	chǎo jià	ทะเลาะ
炒	chǎo	ทอด
车库	chē kù	โรงรถ
车厢	chē xiāng	รถยนต์
彻底	chè dǐ	อย่างละเอียด
沉默	chén mò	ความเงียบ
趁	chèn	ใช้ประโยชน์จาก
称	chēng	น้ำหนัก
称呼	chēng hu	โทร
称赞	chēng zàn	สรรเสริญ
成分	chéng fèn	ส่วนผสม
成果	chéng guǒ	ผล
成就	chéng jiù	ความสำเร็จ
成立	chéng lì	ที่จัดตั้งขึ้น
成人	chéng rén	ผู้ใหญ่
成熟	chéng shú	ผู้ใหญ่
成语	chéng yǔ	สำนวน
成长	chéng zhǎng	โตขึ้น
承担	chéng dān	หมี
承认	chéng rèn	การรับรู้
承受	chéng shòu	หมี
程度	chéng dù	ระดับ
程序	chéng xù	โปรแกรม
诚恳	chéng kěn	จริงใจ
吃亏	chī kuī	ทุกข์
持续	chí xù	ต่อ
池塘	chí táng	บ่อ
迟早	chí zǎo	ไม่ช้าก็เร็ว
尺子	chǐ zi	ไม้บรรทัด
翅膀	chì bǎng	ปีก
充电器	chōng diàn qì	ที่ชาร์จ
充分	chōng fèn	เต็ม
充满	chōng mǎn	เต็ม
冲	chōng	Rush
重复	chóng fù	ทำซ้ำ
宠物	chǒng wù	สัตว์เลี้ยง
抽屉	chōu ti	ลิ้นชัก
抽象	chōu xiàng	บทคัดย่อ
丑	chǒu	น่าเกลียด
臭	chòu	เหม็น
出版	chū bǎn	สำนักพิมพ์
出口	chū kǒu	ทางออก
出色	chū sè	โดดเด่น
出示	chū shì	แสดง
出席	chū xí	เข้าร่วม
初级	chū jí	ประถม
除非	chú fēi	เว้นแต่
除夕	chú xī	วันส่งท้ายปีเก่า
处理	chǔ lǐ	จัดการกับ
传播	chuán bō	การแพร่กระจาย
传染	chuán rǎn	การติดเชื้อ
传说	chuán shuō	ตำนาน
传统	chuán tǒng	แบบดั้งเดิม
窗帘	chuāng lián	ม่าน
闯	chuǎng	Rush
创造	chuàng zào	สร้าง
吹	chuī	เป่า
词汇	cí huì	คำศัพท์
辞职	cí zhí	ลาออก
此外	cǐ wài	นอกจากนี้
刺激	cì jī	กระตุ้น
次要	cì yào	รอง
匆忙	cōng máng	รีบ
从此	cóng cǐ	ตั้งแต่นั้นมา
从而	cóng ér	ดังนั้น
从前	cóng qián	ก่อน
从事	cóng shì	กำลังหมั้น
粗糙	cū cāo	ขรุขระ
促进	cù jìn	ส่งเสริม
促使	cù shǐ	พร้อมท์
醋	cù	น้ำส้มสายชู
催	cuī	กระตุ้น
存在	cún zài	มีอยู่
措施	cuò shī	มาตรการ
答应	dā ying	สัญญา
达到	dá dào	บรรลุ
打工	dǎ gōng	งานชั่วคราว
打交道	dǎ jiāo dào	จัดการกับ
打喷嚏	dǎ pēn tì	จาม
打听	dǎ ting	สอบถามเกี่ยวกับ
大方	dà fāng	ใจกว้าง
大厦	dà shà	อาคาร
大象	dà xiàng	ช้าง
大型	dà xíng	ใหญ่
呆	dāi	อยู่
代表	dài biǎo	ตัวแทน
代替	dài tì	แทน
待遇	dài yù	การรักษา
贷款	dài kuǎn	เงินกู้
单纯	dān chún	เรียบง่าย
单调	dān diào	น่าเบื่อ
单独	dān dú	คนเดียว
单位	dān wèi	หน่วย
单元	dān yuán	หน่วย
担任	dān rèn	ทำหน้าที่เป็น
耽误	dān wu	เดี๋ยวก่อน
胆小鬼	dǎn xiǎo guǐ	คนขี้ขลาด
淡	dàn	เบา
当地	dāng dì	ท้องถิ่น
当心	dāng xīn	ระวัง
挡	dǎng	บล็อก
倒霉	dǎo méi	โชคร้าย
导演	dǎo yǎn	ผู้กำกับ
导致	dǎo zhì	ที่เกิดขึ้นใน
岛屿	dǎo yǔ	หมู่เกาะ
到达	dào dá	ขาเข้า
道德	dào dé	คุณธรรม
道理	dào lǐ	เหตุผล
登记	dēng jì	ลงทะเบียน
等待	děng dài	รอ
等于	děng yú	เท่ากัน
滴	dī	หยด
敌人	dí rén	ศัตรู
的确	dí què	แน่นอน
地道	dì dao	ทั่วไป
地理	dì lǐ	ภูมิศาสตร์
地区	dì qū	พื้นที่
地毯	dì tǎn	พรม
地位	dì wèi	สถานะ
地震	dì zhèn	แผ่นดินไหว
递	dì	ผ่าน
点心	diǎn xin	ขนม
电池	diàn chí	แบตเตอรี่
电台	diàn tái	สถานีวิทยุ
钓	diào	ตกปลา
顶	dǐng	ด้านบน
冻	dòng	แช่แข็ง
动画片	dòng huà piān	การ์ตูน
洞	dòng	หลุม
豆腐	dòu fu	เต้าหู้
逗	dòu	หยอก
独立	dú lì	อิสระ
独特	dú tè	เอกลักษณ์
度过	dù guò	ใช้จ่าย
断	duàn	ตัดออก
堆	duī	กอง
兑换	duì huàn	แลกเปลี่ยน
对比	duì bǐ	เปรียบเทียบ
对待	duì dài	รักษา
对方	duì fāng	ด้านอื่น ๆ
对手	duì shǒu	ฝ่ายตรงข้าม
对象	duì xiàng	วัตถุ
吨	dūn	ตัน
蹲	dūn	หมอบ
顿	dùn	หยุด
多亏	duō kuī	ขอบคุณ
多余	duō yú	ซ้ำซ้อน
朵	duǒ	ทำ
躲藏	duǒ cáng	ซ่อน
恶劣	è liè	แย่
耳环	ěr huán	ต่างหู
发表	fā biǎo	เผยแพร่
发愁	fā chóu	กังวล
发达	fā dá	พัฒนาแล้ว
发抖	fā dǒu	ตัวสั่น
发挥	fā huī	เล่น
发明	fā míng	สิ่งประดิษฐ์
发票	fā piào	ใบแจ้งหนี้
发言	fā yán	พูด
罚款	fá kuǎn	ละเอียด
法院	fǎ yuàn	ศาล
翻	fān	กลับ
繁荣	fán róng	ความเจริญรุ่งเรือง
反而	fǎn ér	แทน
反复	fǎn fù	ซ้ำแล้วซ้ำเล่า
反应	fǎn yìng	ปฏิกิริยา
反映	fǎn yìng	สะท้อน
反正	fǎn zhèng	อย่างไรก็ตาม
范围	fàn wéi	พิสัย
方	fāng	สี่เหลี่ยม
方案	fāng àn	โปรแกรม
方式	fāng shì	ทาง
妨碍	fáng ài	ขัดขวาง
仿佛	fǎng fú	เหมือนกับ
非	fēi	ไม่ใช่
肥皂	féi zào	สบู่ก้อน
废话	fèi huà	เรื่องไร้สาระ
分别	fēn bié	ตามลำดับ
分布	fēn bù	แจกจ่าย
分配	fēn pèi	การกระจาย
分手	fēn shǒu	เลิกกัน
分析	fēn xī	บทวิเคราะห์
纷纷	fēn fēn	ทีละคน
奋斗	fèn dòu	การต่อสู้
疯狂	fēng kuáng	บ้า
风格	fēng gé	สไตล์
风景	fēng jǐng	ภูมิทัศน์
风俗	fēng sú	กำหนดเอง
风险	fēng xiǎn	ความเสี่ยง
讽刺	fěng cì	ประชด
否定	fǒu dìng	เชิงลบ
否认	fǒu rèn	ปฏิเสธ
幅	fú	ความกว้าง
扶	fú	ช่วยด้วย
服装	fú zhuāng	เสื้อผ้า
辅导	fǔ dǎo	การฝึกสอน
复制	fù zhì	สำเนา
妇女	fù nv3	ผู้หญิง
改革	gǎi gé	ปฏิรูป
改进	gǎi jìn	ทำให้ดีขึ้น
改善	gǎi shàn	ทำให้ดีขึ้น
改正	gǎi zhèng	แก้ไข
概括	gài kuò	สรุป General
概念	gài niàn	แนวคิด
盖	gài	ปก
干脆	gān cuì	ง่ายๆ
干燥	gān zào	แห้ง
感激	gǎn jī	กตัญญู
感受	gǎn shòu	รู้สึก
感想	gǎn xiǎng	ความคิด
赶紧	gǎn jǐn	เร็วเข้า
赶快	gǎn kuài	รีบขึ้น
干活儿	gàn huó r	งาน
钢铁	gāng tiě	เหล็ก
高档	gāo dàng	ระดับไฮเอนด์
高级	gāo jí	ขั้นสูง
搞	gǎo	กำลังหมั้น
告别	gào bié	อำลา
格外	gé wài	โดยเฉพาะ
隔壁	gé bì	ประตูถัดไป
个别	gè bié	รายบุคคล
个人	gè rén	ส่วนตัว
个性	gè xìng	บุคลิกภาพ
各自	gè zì	ตามลำดับ
根	gēn	ราก
根本	gēn běn	พื้นฐาน
公布	gōng bù	ประกาศ
公开	gōng kāi	สาธารณะ
公平	gōng píng	ยุติธรรม
公寓	gōng yù	คอนโดมิเนียม
公元	gōng yuán	ค.ศ.
公主	gōng zhǔ	เจ้าหญิง
功能	gōng néng	คุณสมบัติ
工厂	gōng chǎng	โรงงาน
工程师	gōng chéng shī	วิศวกร
工具	gōng jù	เครื่องมือ
工人	gōng rén	คนงาน
工业	gōng yè	อุตสาหกรรม
恭喜	gōng xǐ	ขอแสดงความยินดี
贡献	gòng xiàn	ผลงาน
沟通	gōu tōng	การสื่อสาร
构成	gòu chéng	เป็น
姑姑	gū gu	ป้า
姑娘	gū niang	สาว
古代	gǔ dài	โบราณ
古典	gǔ diǎn	คลาสสิก
股票	gǔ piào	คลังสินค้า
骨头	gǔ tou	กระดูก
鼓舞	gǔ wǔ	แรงบันดาลใจ
鼓掌	gǔ zhǎng	ปรบมือ
固定	gù dìng	แก้ไขแล้ว
挂号	guà hào	จดทะเบียน
乖	guāi	เชื่อฟัง
拐弯	guǎi wān	กลับ
怪不得	guài bu de	ไม่แปลกใจเลย
关闭	guān bì	ปิดตัวลง
官	guān	เป็นทางการ
观察	guān chá	สังเกต
观点	guān diǎn	ดู
观念	guān niàn	ไอเดีย
管子	guǎn zǐ	หลอด
冠军	guàn jūn	แชมป์
光滑	guāng hua	เรียบ
光临	guāng lín	มานี่สิ
光明	guāng míng	สดใส
光盘	guāng pán	ซีดี
广场	guǎng chǎng	สี่เหลี่ยม
广大	guǎng dà	กว้างใหญ่
广泛	guǎng fàn	อย่างกว้างขวาง
归纳	guī nà	การเหนี่ยวนำ
规矩	guī ju	กฎ
规律	guī lv4	กฎหมาย
规模	guī mó	มาตราส่วน
规则	guī zé	กฎ
柜台	guì tái	เคาน์เตอร์
滚	gǔn	ม้วน
锅	guō	หม้อ
国庆节	guó qìng jié	วันชาติ
国王	guó wáng	กษัตริย์
果然	guǒ rán	จริงๆ
果实	guǒ shí	ผลไม้
过分	guò fèn	มากเกินไป
过敏	guò mǐn	ภูมิแพ้
过期	guò qī	หมดอายุ
哈	hā	อะไร
海关	hǎi guān	ศุลกากร
海鲜	hǎi xiān	อาหารทะเล
喊	hǎn	โทร
行业	háng yè	อุตสาหกรรม
豪华	háo huá	หรูหรา
好客	hào kè	ใจดี
好奇	hào qí	อยากรู้อยากเห็น
何必	hé bì	ทำไมต้องกวน
何况	hé kuàng	ไม่ต้องพูดถึง
合法	hé fǎ	ถูกกฎหมาย
合理	hé lǐ	มีเหตุผล
合同	hé tong	สัญญา
合影	hé yǐng	ถ่ายรูปหมู่
合作	hé zuò	ความร่วมมือ
和平	hé píng	ความสงบ
核心	hé xīn	แกน
恨	hèn	เกลียด
猴子	hóu zi	ลิง
后背	hòu bèi	กลับ
后果	hòu guǒ	อันเป็นผลมาจาก
呼吸	hū xī	หายใจ
忽然	hū rán	กะทันหัน
忽视	hū shì	ละเว้น
壶	hú	หม้อ
糊涂	hú tu	สับสน
胡说	hú shuō	เรื่องไร้สาระ
胡同	hú tòng	ซอย
蝴蝶	hú dié	ผีเสื้อ
花生	huā shēng	ถั่วลิสง
华裔	huá yì	ชาวจีน
滑	huá	ลื่น
划	huà	วาด
化学	huà xué	เคมี
话题	huà tí	หัวข้อ
怀念	huái niàn	นางสาว
怀孕	huái yùn	ตั้งครรภ์
缓解	huǎn jiě	สบาย
幻想	huàn xiǎng	แฟนตาซี
慌张	huāng zhāng	ตื่นตกใจ
黄金	huáng jīn	ทอง
恢复	huī fù	คืนค่า
挥	huī	คลื่น
灰	huī	สีเทา
灰尘	huī chén	ฝุ่น
灰心	huī xīn	ท้อแท้
汇率	huì lv4	อัตราแลกเปลี่ยน
婚礼	hūn lǐ	งานแต่งงาน
婚姻	hūn yīn	การแต่งงาน
活跃	huó yuè	คล่องแคล่ว
伙伴	huǒ bàn	พันธมิตร
火柴	huǒ chái	ไม้ขีด
或许	huò xǔ	บางที
基本	jī běn	ขั้นพื้นฐาน
机器	jī qì	เครื่อง
激烈	jī liè	ดุร้าย
肌肉	jī ròu	กล้ามเนื้อ
及格	jí gé	ผ่าน
急忙	jí máng	อย่างเร่งรีบ
急诊	jí zhěn	เหตุฉุกเฉิน
极其	jí qí	สุดๆ
集合	jí hé	ชุด
集体	jí tǐ	กลุ่ม
集中	jí zhōng	เข้มข้น
寂寞	jì mò	โดดเดี่ยว
系领带	jì lǐng dài	ใส่เนคไท
纪录	jì lù	บันทึก
纪律	jì lv4	วินัย
纪念	jì niàn	รำลึก
计算	jì suàn	การคำนวณ
记录	jì lù	การบันทึก
记忆	jì yì	หน่วยความจำ
嘉宾	jiā bīn	แขก
夹子	jiā zi	คลิป
家庭	jiā tíng	ครอบครัว
家务	jiā wù	งานบ้าน
家乡	jiā xiāng	บ้านเกิด
假如	jiǎ rú	ถ้า
假设	jiǎ shè	สมมติฐาน
假装	jiǎ zhuāng	แกล้ง
甲	jiǎ	อา
价值	jià zhí	ความคุ้มค่า
嫁	jià	แต่งงาน
驾驶	jià shǐ	ขับรถ
兼职	jiān zhí	ไม่เต็มเวลา
坚决	jiān jué	เฉียบขาด
坚强	jiān qiáng	แข็งแกร่ง
肩膀	jiān bǎng	ไหล่
艰巨	jiān jù	ยาก
艰苦	jiān kǔ	ยาก
剪刀	jiǎn dāo	กรรไกร
捡	jiǎn	ไปรับ
简历	jiǎn lì	ประวัติย่อ
简直	jiǎn zhí	ง่ายๆ
健身	jiàn shēn	ฟิตเนส
建立	jiàn lì	ติดตั้ง
建设	jiàn shè	การก่อสร้าง
建筑	jiàn zhù	อาคาร
键盘	jiàn pán	แป้นพิมพ์
讲究	jiǎng jiu	ให้ความสนใจกับ
讲座	jiǎng zuò	บรรยาย
酱油	jiàng yóu	ซีอิ๊ว
交换	jiāo huàn	แลกเปลี่ยน
交际	jiāo jì	การสื่อสาร
交往	jiāo wǎng	ที่เกี่ยวข้อง
浇	jiāo	เท
胶水	jiāo shuǐ	กาว
狡猾	jiǎo huá	เจ้าเล่ห์
角度	jiǎo dù	มุม
教材	jiào cái	หนังสือเรียน
教练	jiào liàn	โค้ช
教训	jiào xun	บทเรียน
接触	jiē chù	ติดต่อ
接待	jiē dài	แผนกต้อนรับ
接近	jiē jìn	ใกล้กับ
结实	jiē shi	แข็ง
阶段	jiē duàn	เวที
结构	jié gòu	โครงสร้าง
结合	jié hé	รวมกัน
结论	jié lùn	สรุปแล้ว
结账	jié zhàng	เก็บเงินด้วยค่ะ
节省	jié shěng	บันทึก
借口	jiè kǒu	ขอโทษ
届	jiè	เซสชั่น
戒	jiè	เลิก
戒指	jiè zhi	แหวน
金属	jīn shǔ	โลหะ
尽快	jǐn kuài	โดยเร็วที่สุด
紧急	jǐn jí	ด่วน
谨慎	jǐn shèn	ระมัดระวัง
尽力	jìn lì	ทำให้ดีที่สุด
尽量	jìn liàng	พยายามที่จะ
近代	jìn dài	สมัยใหม่
进步	jìn bù	ความคืบหน้า
进口	jìn kǒu	นำเข้า
精力	jīng lì	พลังงาน
精神	jīng shén	วิญญาณ
经典	jīng diǎn	คลาสสิค
经商	jīng shāng	ทำธุรกิจ
经营	jīng yíng	ปฏิบัติการ
酒吧	jiǔ bā	บาร์
救	jiù	บันทึก
救护车	jiù hù chē	รถพยาบาล
舅舅	jiù jiu	ลุง
居然	jū rán	กะทันหัน
桔子	jú zi	ส้ม
俱乐部	jù lè bù	คลับ
具备	jù bèi	มี
具体	jù tǐ	เฉพาะ
巨大	jù dà	ใหญ่โต
据说	jù shuō	ว่ากันว่า
捐	juān	บริจาค
决赛	jué sài	รอบชิงชนะเลิศ
决心	jué xīn	การกำหนด
绝对	jué duì	แน่นอน
角色	jué sè	ตัวละคร
军事	jūn shì	ทหาร
均匀	jūn yún	สม่ำเสมอ
卡车	kǎ chē	รถบรรทุก
开发	kāi fā	การพัฒนา
开放	kāi fàng	เปิด
开幕式	kāi mù shì	พิธีเปิด
开水	kāi shuǐ	น้ำเดือด
砍	kǎn	ตัด
看不起	kàn bu qǐ	ชัง
看望	kàn wàng	เยี่ยมชม
靠	kào	โดย
颗	kē	ชิ้น
可见	kě jiàn	มองเห็นได้
可靠	kě kào	เชื่อถือได้
可怕	kě pà	แย่มาก
克	kè	กรัม
克服	kè fú	รับมากกว่า
刻苦	kè kǔ	การทำงานอย่างหนัก
客观	kè guān	วัตถุประสงค์
课程	kè chéng	แน่นอน
空间	kōng jiān	พื้นที่
控制	kòng zhì	ควบคุม
空闲	kòng xián	ไม่ได้ใช้งาน
口味	kǒu wèi	ลิ้มรส
夸	kuā	โม้
夸张	kuā zhāng	การพูดเกินจริง
会计	kuài jì	การบัญชี
宽	kuān	ความกว้าง
昆虫	kūn chóng	แมลง
扩大	kuò dà	ขยาย
辣椒	là jiāo	พริก
拦	lán	บาร์
烂	làn	เน่าเสีย
朗读	lǎng dú	อ่านออกเสียง
劳动	láo dòng	แรงงาน
劳驾	láo jià	ขออนุญาต
姥姥	lǎo lao	ยาย
老百姓	lǎo bǎi xìng	สามัญชน
老板	lǎo bǎn	เจ้านาย
老婆	lǎo pó	ภรรยา
老实	lǎo shi	ซื่อสัตย์
老鼠	lǎo shǔ	เมาส์
乐观	lè guān	การมองโลกในแง่ดี
雷	léi	ของฉัน
类型	lèi xíng	ชนิดของ
冷淡	lěng dàn	เย็น
厘米	lí mǐ	ซม
梨	lí	ลูกแพร์
离婚	lí hūn	หย่า
理论	lǐ lùn	ทฤษฎี
理由	lǐ yóu	เหตุผล
利润	lì rùn	กำไร
利息	lì xī	น่าสนใจ
利益	lì yì	น่าสนใจ
利用	lì yòng	ใช้
力量	lì liang	อำนาจ
立即	lì jí	ทันที
立刻	lì kè	ทันที
联合	lián hé	ข้อต่อ
连忙	lián máng	อย่างรวดเร็ว
连续	lián xù	ต่อเนื่อง
恋爱	liàn ài	มีความรัก
粮食	liáng shi	อาหาร
良好	liáng hǎo	ดี
亮	liàng	สดใส
了不起	liǎo bu qǐ	น่าอัศจรรย์
列车	liè chē	รถไฟ
临时	lín shí	ชั่วคราว
灵活	líng huó	ยืดหยุ่น
铃	líng	ระฆัง
零件	líng jiàn	ส่วนประกอบ
零食	líng shí	อาหารว่าง
领导	lǐng dǎo	ความเป็นผู้นำ
领域	lǐng yù	ฟิลด์
流传	liú chuán	การแพร่กระจาย
流泪	liú lèi	น้ำตา
浏览	liú lǎn	เรียกดู
龙	lóng	มังกร
漏	lòu	รั่ว
录取	lù qǔ	การรับเข้า
录音	lù yīn	การบันทึก
陆地	lù dì	ที่ดิน
陆续	lù xù	หนึ่งหลังจากนั้น
轮流	lún liú	กลับ
论文	lùn wén	กระดาษ
逻辑	luó ji	ตรรกะ
落后	luò hòu	ข้างหลัง
骂	mà	คำสาป
麦克风	mài kè fēng	ไมโครโฟน
馒头	mán tou	ขนมปังนึ่ง
满足	mǎn zú	พอใจ
毛病	máo bìng	ความผิด
矛盾	máo dùn	ความขัดแย้ง
冒险	mào xiǎn	การผจญภัย
贸易	mào yì	ซื้อขาย
媒体	méi tǐ	สื่อ
煤炭	méi tàn	ถ่านหิน
眉毛	méi mao	คิ้ว
美术	měi shù	ศิลปะ
魅力	mèi lì	เสน่ห์
梦想	mèng xiǎng	ฝัน
密切	mì qiè	ปิด
秘密	mì mì	ความลับ
秘书	mì shū	เลขานุการ
蜜蜂	mì fēng	ผึ้ง
面对	miàn duì	ใบหน้า
面积	miàn jī	พื้นที่
面临	miàn lín	เผชิญ
描写	miáo xiě	คำอธิบาย
苗条	miáo tiáo	บาง
敏感	mǐn gǎn	อ่อนไหว
名牌	míng pái	แบรนด์ที่มีชื่อเสียง
名片	míng piàn	นามบัตร
名胜古迹	míng shèng gǔ jì	สถานที่น่าสนใจ
明确	míng què	ชัดเจน
明显	míng xiǎn	ชัดเจน
明星	míng xīng	คนดัง
命令	mìng lìng	คำสั่ง
命运	mìng yùn	ชะตากรรม
摸	mō	สัมผัส
摩托车	mó tuō chē	รถจักรยานยนต์
模仿	mó fǎng	เลียนแบบ
模糊	mó hu	พร่ามัว
模特	mó tè	รุ่น
陌生	mò shēng	แปลก
某	mǒu	แน่นอน
木头	mù tou	ไม้
目标	mù biāo	จุดมุ่งหมาย
目录	mù lù	สารบัญ
目前	mù qián	ปัจจุบัน
哪怕	nǎ pà	แม้ว่า
难怪	nán guài	ไม่น่าแปลกใจเลย
难免	nán miǎn	หลีกเลี่ยงไม่ได้
脑袋	nǎo dài	ศีรษะ
内部	nèi bù	ภายใน
内科	nèi kē	อายุรศาสตร์
嫩	nèn	ซื้อ
能干	néng gàn	มีความสามารถ
能源	néng yuán	พลังงาน
嗯	ńg	ตกลง
年代	nián dài	ปี
年纪	nián jì	อายุ
念	niàn	อ่าน
宁可	nìng kě	ค่อนข้าง
牛仔裤	niú zǎi kù	กางเกงยีนส์
农村	nóng cūn	เขตชนบท
农民	nóng mín	ชาวนา
农业	nóng yè	เกษตรกรรม
浓	nóng	เข้มข้น
女士	nv3 shì	นางสาว
欧洲	ōu zhōu	ยุโรป
偶然	ǒu rán	โดยบังเอิญ
拍	pāi	ยิง
派	pài	ส่ง
盼望	pàn wàng	หวัง
培训	péi xùn	การฝึกอบรม
培养	péi yǎng	เพื่อปลูกฝัง
赔偿	péi cháng	ค่าตอบแทน
佩服	pèi fú	ชื่นชม
配合	pèi hé	ร่วมมือ
盆	pén	กระถาง
碰	pèng	ชน
批	pī	แบทช์
批准	pī zhǔn	อนุมัติ
披	pī	พี
疲劳	pí láo	ความเหนื่อยล้า
匹	pǐ	การจับคู่
片	piàn	แผ่น
片面	piàn miàn	ด้านเดียว
飘	piāo	ด้วยสายลม
拼音	pīn yīn	พินอิน
频道	pín dào	ช่อง
凭	píng	พึ่ง
平均	píng jūn	เฉลี่ย
平	píng	ระดับ
平安	píng 'ān	ปลอดภัย
平常	píng cháng	โดยปกติ
平等	píng děng	ความเท่าเทียมกัน
平方	píng fāng	สี่เหลี่ยมจัตุรัส
平衡	píng héng	สมดุล
平静	píng jìng	เงียบสงบ
评价	píng jià	การประเมินผล
破产	pò chǎn	การล้มละลาย
破坏	pò huài	ความเสียหาย
迫切	pò qiè	เร่งด่วน
期待	qī dài	ตั้งตารอคอย
期间	qī jiān	งวด
其余	qí yú	ส่วนที่เหลือ
奇迹	qí jì	ปาฏิหาริย์
企业	qǐ yè	องค์กร
启发	qǐ fā	รู้แจ้ง
气氛	qì fēn	บรรยากาศ
汽油	qì yóu	น้ำมันเบนซิน
签	qiān	ลงชื่อ
谦虚	qiān xū	เจียมเนื้อเจียมตัว
前途	qián tú	อนาคต
浅	qiǎn	ตื้น
欠	qiàn	เป็นหนี้
枪	qiāng	ปืน
墙	qiáng	ผนัง
强调	qiáng diào	เน้น
强烈	qiáng liè	แข็งแรง
抢	qiǎng	คว้า
悄悄	qiāo qiāo	เงียบ ๆ
瞧	qiáo	ดู
巧妙	qiǎo miào	ฉลาด
切	qiē	ตัด
亲爱	qīn ài	ที่รัก
亲切	qīn qiè	ชนิด
亲自	qīn zì	ส่วนตัว
勤奋	qín fèn	ขยัน
清淡	qīng dàn	เบา
轻视	qīng shì	ดูถูก
轻易	qīng yì	ได้อย่างง่ายดาย
青	qīng	เขียว
青春	qīng chūn	เยาวชน
青少年	qīng shào nián	วัยรุ่น
情景	qíng jǐng	ฉาก
情绪	qíng xù	อารมณ์
请求	qǐng qiú	คำขอ
庆祝	qìng zhù	ฉลอง
球迷	qiú mí	พัดลม
趋势	qū shì	แนวโน้ม
取消	qǔ xiāo	ยกเลิก
娶	qǔ	แต่งงาน
去世	qù shì	เสียชีวิตแล้ว
圈	quān	แหวน
全面	quán miàn	ครอบคลุม
权利	quán lì	ขวา
权力	quán lì	พลังนั้น
劝	quàn	ให้คำแนะนำ
缺乏	quē fá	ขาด
确定	què dìng	กำหนด
确认	què rèn	ยืนยัน
群	qún	กลุ่ม
燃烧	rán shāo	การเผาไหม้
绕	rào	รอบ ๆ
热爱	rè ài	รัก
热烈	rè liè	อบอุ่น
热心	rè xīn	กระตือรือร้น
人才	rén cái	พรสวรรค์
人口	rén kǒu	ประชากร
人类	rén lèi	มนุษยชาติ
人民币	rén mín bì	หยวน
人生	rén shēng	ชีวิต
人事	rén shì	บุคลากร
人物	rén wù	ตัวละคร
人员	rén yuán	บุคลากร
忍不住	rěn bu zhù	ช่วยไม่ได้
日常	rì cháng	ทุกวัน
日程	rì chéng	กำหนดการ
日历	rì lì	ปฏิทิน
日期	rì qī	วันที่
日用品	rì yòng pǐn	ของใช้ในชีวิตประจำวัน
日子	rì zi	วัน
如何	rú hé	เป็นยังไงบ้าง
如今	rú jīn	ตอนนี้
软	ruǎn	อ่อนนุ่ม
软件	ruǎn jiàn	ซอฟต์แวร์
弱	ruò	อ่อนแอ
洒	sǎ	โรย
嗓子	sǎng zi	เสียง
色彩	sè cǎi	สี
杀	shā	ฆ่า
沙漠	shā mò	ทะเลทราย
沙滩	shā tān	ชายหาด
傻	shǎ	โง่
晒	shài	แสดง
删除	shān chú	ลบ
闪电	shǎn diàn	ฟ้าผ่า
善良	shàn liáng	ความกรุณา
善于	shàn yú	ดีที่
扇子	shàn zi	พัดลม
伤害	shāng hài	เจ็บ
商品	shāng pǐn	สินค้า
商务	shāng wù	ธุรกิจ
商业	shāng yè	ธุรกิจ
上当	shàng dàng	หลอก
蛇	shé	งู
舍不得	shě bu de	ไม่เต็มใจ
射击	shè jī	ยิง
摄影	shè yǐng	การถ่ายภาพ
设备	shè bèi	อุปกรณ์
设计	shè jì	ออกแบบ
设施	shè shī	สิ่งอำนวยความสะดวก
伸	shēn	ยืด
深刻	shēn kè	ลึกซึ้ง
身材	shēn cái	รูป
身份	shēn fèn	เอกลักษณ์
神话	shén huà	ตำนาน
神秘	shén mì	ลึกลับ
升	shēng	ลุกขึ้น
声调	shēng diào	โทน
生产	shēng chǎn	ผลิต
生动	shēng dòng	สดใส
生长	shēng zhǎng	เติบโต
绳子	shéng zi	เชือก
省略	shěng lüè	ละเว้น
胜利	shèng lì	ชัยชนะ
失眠	shī mián	นอนไม่หลับ
失去	shī qù	แพ้
失业	shī yè	การว่างงาน
湿润	shī rùn	ชื้น
狮子	shī zi	สิงโต
诗	shī	กวีนิพนธ์
实话	shí huà	ความจริง
实践	shí jiàn	การปฏิบัติ
实习	shí xí	การปฏิบัติ
实现	shí xiàn	บรรลุ
实验	shí yàn	การทดลอง
实用	shí yòng	ในทางปฏิบัติ
时差	shí chā	เจ็ตแล็ก
时代	shí dài	ยุค
时刻	shí kè	เวลา
时髦	shí máo	ทันสมัย
时期	shí qī	งวด
时尚	shí shàng	แฟชั่น
石头	shí tou	หิน
食物	shí wù	อาหาร
使劲儿	shǐ jìn r	ยาก
始终	shǐ zhōng	เสมอ
事实	shì shí	ข้อเท็จจริง
事物	shì wù	สิ่ง
事先	shì xiān	ล่วงหน้า
似的	shì de	ชอบ
士兵	shì bīng	ทหาร
市场	shì chǎng	ตลาด
试卷	shì juàn	กระดาษทดสอบ
收获	shōu huò	รางวัล
收据	shōu jù	ใบเสร็จรับเงิน
手工	shǒu gōng	คู่มือ
手术	shǒu shù	ศัลยกรรม
手套	shǒu tào	ถุงมือ
手续	shǒu xù	พิธีการ
手指	shǒu zhǐ	นิ้ว
首	shǒu	อันดับแรก
受伤	shòu shāng	ได้รับบาดเจ็บ
寿命	shòu mìng	ชีวิต
书架	shū jià	ชั้นวางหนังสือ
梳子	shū zi	หวี
舒适	shū shì	สะดวกสบาย
蔬菜	shū cài	ผัก
输入	shū rù	ป้อน
熟练	shú liàn	มีฝีมือ
属于	shǔ yú	เป็นของ
数	shǔ	จำนวน
鼠标	shǔ biāo	เมาส์
数据	shù jù	ข้อมูล
数码	shù mǎ	ดิจิทัล
摔倒	shuāi dǎo	ตก
甩	shuǎi	การถ่ายโอนข้อมูล
双方	shuāng fāng	ทั้งสองด้าน
税	shuì	ภาษี
说不定	shuō bu dìng	อาจจะ
说服	shuō fú	โน้มน้าว
丝绸	sī chóu	ผ้าไหม
丝毫	sī háo	น้อยที่สุด
思考	sī kǎo	กำลังคิด
思想	sī xiǎng	ความคิด
撕	sī	ฉีก
私人	sī rén	เอกชน
似乎	sì hū	ดูเหมือน
搜索	sōu suǒ	ค้นหา
宿舍	sù shè	ห้องพัก
随身	suí shēn	พก
随时	suí shí	ตอนไหนก็ได้
随手	suí shǒu	ลวก
碎	suì	เสีย
损失	sǔn shī	ขาดทุน
缩短	suō duǎn	ทำให้สั้นลง
所	suǒ	ดังนั้น
锁	suǒ	ล็อค
台阶	tái jiē	ขั้นตอน
太极拳	tài jí quán	ไทเก็ก
太太	tài tai	นาง
谈判	tán pàn	การเจรจาต่อรอง
坦率	tǎn shuài	ตรงไปตรงมา
烫	tàng	ร้อน
桃	táo	ลูกพีช
淘气	táo qì	ซน
逃	táo	หนี
逃避	táo bì	หนี
讨价还价	tǎo jià huán jià	ต่อรอง
套	tào	ชุด
特色	tè sè	คุณสมบัติ
特殊	tè shū	พิเศษ
特征	tè zhēng	ลักษณะเฉพาะ
疼爱	téng ài	รัก
提倡	tí chàng	ส่งเสริม
提纲	tí gāng	โครงร่าง
提问	tí wèn	ถามคำถาม
题目	tí mù	หัวข้อ
体会	tǐ huì	ประสบการณ์
体贴	tǐ tiē	เกรงใจ
体现	tǐ xiàn	สะท้อน
体验	tǐ yàn	ประสบการณ์
天空	tiān kōng	ท้องฟ้า
天真	tiān zhēn	ไร้เดียงสา
调皮	tiáo pí	ซน
调整	tiáo zhěng	การปรับ
挑战	tiǎo zhàn	ท้าทาย
通常	tōng cháng	โดยปกติ
统一	tǒng yī	รวมกัน
痛苦	tòng kǔ	ความเจ็บปวด
痛快	tòng kuài	มีความสุข
偷	tōu	ขโมย
投入	tóu rù	ลงทุนใน
投资	tóu zī	การลงทุน
透明	tòu míng	โปร่งใส
突出	tū chū	โดดเด่น
土地	tǔ dì	ที่ดิน
土豆	tǔ dòu	มันฝรั่ง
兔子	tù zi	กระต่าย
吐	tù	โยนขึ้น
团	tuán	กลุ่ม
推辞	tuī cí	ลดลง
推广	tuī guǎng	ส่งเสริม
推荐	tuī jiàn	แนะนำ
退	tuì	ล่าถอย
退步	tuì bù	ถอยหลัง
退休	tuì xiū	เกษียณอายุ
歪	wāi	คดเคี้ยว
外公	wài gōng	คุณปู่
外交	wài jiāo	ทางการทูต
完美	wán měi	สมบูรณ์แบบ
完善	wán shàn	สมบูรณ์แบบ
完整	wán zhěng	เสร็จสมบูรณ์
玩具	wán jù	ของเล่น
万一	wàn yī	ในกรณี
王子	wáng zǐ	เจ้าชาย
往返	wǎng fǎn	ไป - กลับ
网络	wǎng luò	อินเตอร์เนต
危害	wēi hài	อันตราย
威胁	wēi xié	ภัยคุกคาม
微笑	wēi xiào	ยิ้ม
唯一	wéi yī	เท่านั้น
围巾	wéi jīn	ผ้าพันคอ
围绕	wéi rào	รอบ ๆ
维修	wéi xiū	บริการ
违反	wéi fǎn	การละเมิด
伟大	wěi dà	เยี่ยมมาก
委屈	wěi qū	ผิด
尾巴	wěi ba	หาง
位于	wèi yú	นอนอยู่
位置	wèi zhi	ตำแหน่ง
未必	wèi bì	ไม่จำเป็น
未来	wèi lái	อนาคต
胃	wèi	ท้อง
胃口	wèi kǒu	ความกระหาย
温暖	wēn nuǎn	อบอุ่น
温柔	wēn róu	อ่อนโยน
文件	wén jiàn	ไฟล์
文具	wén jù	เครื่องเขียน
文明	wén míng	อารยธรรม
文学	wén xué	วรรณกรรม
文字	wén zì	ข้อความ
闻	wén	กลิ่น
吻	wěn	จูบ
稳定	wěn dìng	มั่นคง
问候	wèn hòu	ทักทาย
卧室	wò shì	ห้องนอน
握手	wò shǒu	สัมผัสมือ
屋子	wū zi	ห้อง
无奈	wú nài	ทำอะไรไม่ถูก
无数	wú shù	นับไม่ถ้วน
无所谓	wú suǒ wèi	ไม่สำคัญ
武术	wǔ shù	ศิลปะการต่อสู้
勿	wù	อย่า
物理	wù lǐ	ทางกายภาพ
物质	wù zhì	สาร
雾	wù	หมอก
吸取	xī qǔ	วาด
吸收	xī shōu	ดูดซับ
戏剧	xì jù	ละคร
系	xì	ระบบ
系统	xì tǒng	ระบบ
细节	xì jié	รายละเอียด
瞎	xiā	ตาบอด
下载	xià zǎi	ดาวน์โหลด
吓	xià	ทำให้ตกใจ
夏令营	xià lìng yíng	ค่ายฤดูร้อน
鲜艳	xiān yàn	สดใส
显得	xiǎn de	ปรากฏ
显然	xiǎn rán	เห็นได้ชัด
显示	xiǎn shì	แสดง
县	xiàn	เขต
现代	xiàn dài	ทันสมัย
现实	xiàn shí	ความเป็นจริง
现象	xiàn xiàng	ปรากฏการณ์
限制	xiàn zhì	ขีด จำกัด
相处	xiāng chǔ	เข้ากันได้
相当	xiāng dāng	ค่อนข้าง
相对	xiāng duì	ค่อนข้าง
相关	xiāng guān	ที่เกี่ยวข้อง
相似	xiāng sì	คล้ายกัน
香肠	xiāng cháng	ไส้กรอก
享受	xiǎng shòu	สนุก
想念	xiǎng niàn	นางสาว
想象	xiǎng xiàng	ลองนึกภาพ
象棋	xiàng qí	หมากรุก
象征	xiàng zhēng	สัญลักษณ์
项	xiàng	สิ่งของ
项链	xiàng liàn	สร้อยคอ
项目	xiàng mù	โครงการ
消费	xiāo fèi	การบริโภค
消化	xiāo huà	การย่อย
消极	xiāo jí	เชิงลบ
消失	xiāo shī	หายไป
销售	xiāo shòu	ฝ่ายขาย
小麦	xiǎo mài	ข้าวสาลี
小气	xiǎo qi	ตระหนี่
孝顺	xiào shun	ลูกกตัญญู
效率	xiào lv4	ประสิทธิผล
歇	xiē	พักผ่อน
斜	xié	เฉียง
写作	xiě zuò	การเขียน
心理	xīn lǐ	ทางจิตวิทยา
心脏	xīn zàng	หัวใจ
欣赏	xīn shǎng	สนุก
信号	xìn hào	สัญญาณ
信任	xìn rèn	ความไว้วางใจ
形成	xíng chéng	แบบฟอร์ม
形容	xíng róng	อธิบาย
形势	xíng shì	สถานการณ์
形式	xíng shì	แบบฟอร์ม
形象	xíng xiàng	ภาพ
形状	xíng zhuàng	รูปร่าง
行动	xíng dòng	หนังบู๊
行人	xíng rén	คนเดินเท้า
行为	xíng wéi	พฤติกรรม
幸亏	xìng kuī	โชคดี
幸运	xìng yùn	โชคดี
性质	xìng zhì	ธรรมชาติ
兄弟	xiōng dì	พี่น้อง
胸	xiōng	หน้าอก
休闲	xiū xián	สบาย ๆ
修改	xiū gǎi	แก้ไข
虚心	xū xīn	เจียมเนื้อเจียมตัว
叙述	xù shù	บรรยาย
宣布	xuān bù	ประกาศ
宣传	xuān chuán	การเผยแพร่
学历	xué lì	การศึกษา
学术	xué shù	วิชาการ
学问	xué wèn	ความรู้
血	xuè	เลือด
寻找	xún zhǎo	ค้นหา
询问	xún wèn	ถาม
训练	xùn liàn	การฝึกอบรม
迅速	xùn sù	อย่างรวดเร็ว
押金	yā jīn	เงินฝาก
牙齿	yá chǐ	ฟัน
严肃	yán sù	จริงจัง
延长	yán cháng	ขยาย
演讲	yǎn jiǎng	คำพูด
宴会	yàn huì	จัดเลี้ยง
阳台	yáng tái	ระเบียง
痒	yǎng	คัน
样式	yàng shì	สไตล์
腰	yāo	เอว
摇	yáo	เขย่า
咬	yǎo	กัด
要不	yào bù	หรือ
业务	yè wù	ธุรกิจ
业余	yè yú	สมัครเล่น
夜	yè	กลางคืน
依然	yī rán	ยัง
一辈子	yí bèi zi	อายุการใช้งาน
一旦	yí dàn	ครั้งเดียว
一律	yí lv4	เสมอ
一再	yí zài	ซ้ำ ๆ
一致	yí zhì	สม่ำเสมอ
疑问	yí wèn	สงสัย
移动	yí dòng	มือถือ
移民	yí mín	ตรวจคนเข้าเมือง
遗憾	yí hàn	เสียใจ
乙	yǐ	ข
以及	yǐ jí	เช่นเดียวกับ
以来	yǐ lái	ตั้งแต่
义务	yì wù	ภาระผูกพัน
亿	yì	พันล้าน
意外	yì wài	อุบัติเหตุ
意义	yì yì	ความสำคัญ
议论	yì lùn	การพูดคุย
因而	yīn ér	ดังนั้น
因素	yīn sù	ปัจจัย
银	yín	เงิน
印刷	yìn shuā	พิมพ์
英俊	yīng jùn	หล่อ
英雄	yīng xióng	ฮีโร่
营养	yíng yǎng	โภชนาการ
营业	yíng yè	ธุรกิจ
迎接	yíng jiē	พบกัน
影子	yǐng zi	เงา
应付	yìng fu	ด้ามจับ
应用	yìng yòng	ใบสมัคร
硬	yìng	ยาก
硬件	yìng jiàn	ฮาร์ดแวร์
拥抱	yōng bào	โอบกอด
拥挤	yōng jǐ	แออัด
勇气	yǒng qì	ความกล้าหาญ
用功	yòng gōng	ทำงานหนัก
用途	yòng tú	ใช้
优惠	yōu huì	ส่วนลด
优美	yōu měi	สวย
优势	yōu shì	ความได้เปรียบ
悠久	yōu jiǔ	ยาว
油炸	yóu zhá	ทอด
游览	yóu lǎn	ทัวร์
犹豫	yóu yù	ลังเล
有利	yǒu lì	ดี
幼儿园	yòu ér yuán	โรงเรียนอนุบาล
娱乐	yú lè	ความบันเทิง
与其	yǔ qí	แทน
语气	yǔ qì	โทน
玉米	yù mǐ	ข้าวโพด
预报	yù bào	พยากรณ์
预订	yù dìng	การจอง
预防	yù fáng	การป้องกัน
元旦	yuán dàn	วันปีใหม่
原料	yuán liào	วัตถุดิบ
原则	yuán zé	โดยหลักการแล้ว
员工	yuán gōng	พนักงาน
圆	yuán	รอบ
愿望	yuàn wàng	ความต้องการ
乐器	yuè qì	เครื่องดนตรี
晕	yūn	เอ้ย
运气	yùn qi	โชค
运输	yùn shū	ขนส่ง
运用	yùn yòng	ใช้
灾害	zāi hài	ภัยพิบัติ
再三	zài sān	ซ้ำ ๆ
在乎	zài hu	การดูแล
在于	zài yú	อยู่ใน
赞成	zàn chéng	ตกลง
赞美	zàn měi	สรรเสริญ
糟糕	zāo gāo	ไม่ดี
造成	zào chéng	สาเหตุ
则	zé	แล้ว
责备	zé bèi	ตำหนิ
摘	zhāi	เลือก
窄	zhǎi	แคบ
粘贴	zhān tiē	วาง
展开	zhǎn kāi	แฉ
展览	zhǎn lǎn	นิทรรศการ
占	zhàn	ขึ้น
战争	zhàn zhēng	สงคราม
掌握	zhǎng wò	เข้าใจ
涨	zhǎng	ลุกขึ้น
长辈	zhǎng bèi	พี่
账户	zhàng hù	บัญชีผู้ใช้
招待	zhāo dài	ความบันเทิง
着火	zháo huǒ	ไฟไหม้
着凉	zháo liáng	เป็นหวัด
召开	zhào kāi	ถือ
照常	zhào cháng	เหมือนอย่างเคย
哲学	zhé xué	ปรัชญา
珍惜	zhēn xī	หวงแหน
真实	zhēn shí	จริง
针对	zhēn duì	ต่อต้าน
诊断	zhěn duàn	การวินิจฉัย
振动	zhèn dòng	การสั่นสะเทือน
阵	zhèn	อาร์เรย์
争论	zhēng lùn	อภิปราย
争取	zhēng qǔ	แสวง
征求	zhēng qiú	แสวงหา
挣	zhēng	ได้รับ
睁	zhēng	เปิดตา
整个	zhěng gè	ทั้งหมด
整齐	zhěng qí	เรียบร้อย
整体	zhěng tǐ	โดยรวม
政府	zhèng fǔ	รัฐบาล
政治	zhèng zhì	ทางการเมือง
正	zhèng	บวก
证件	zhèng jiàn	ใบรับรอง
证据	zhèng jù	หลักฐาน
支	zhī	สนับสนุน
支票	zhī piào	ตรวจสอบ
执照	zhí zhào	ใบอนุญาต
直	zhí	ตรง
指导	zhǐ dǎo	คู่มือ
指挥	zhǐ huī	คำสั่ง
制定	zhì dìng	ทำ
制度	zhì dù	ระบบ
制造	zhì zào	การผลิต
制作	zhì zuò	ทำ
志愿者	zhì yuàn zhě	อาสาสมัคร
智慧	zhì huì	ภูมิปัญญา
治疗	zhì liáo	การรักษา
秩序	zhì xù	ใบสั่ง
至今	zhì jīn	จนถึงปัจจุบัน
至于	zhì yú	ส่วน
中介	zhōng jiè	ตัวกลาง
中心	zhōng xīn	ศูนย์
中旬	zhōng xún	กลางเทอม
种类	zhǒng lèi	สายพันธุ์
重大	zhòng dà	รายใหญ่
重量	zhòng liàng	น้ำหนัก
周到	zhōu dao	รอบคอบ
猪	zhū	หมู
竹子	zhú zi	ไม้ไผ่
逐步	zhú bù	เป็นขั้นเป็นตอน
逐渐	zhú jiàn	ค่อยๆ
主持	zhǔ chí	โฮสต์
主动	zhǔ dòng	ความคิดริเริ่ม
主观	zhǔ guān	อัตนัย
主人	zhǔ rén	เจ้าภาพ
主任	zhǔ rèn	ผู้อำนวยการ
主题	zhǔ tí	ธีม
主席	zhǔ xí	ประธาน
主张	zhǔ zhāng	อ้างสิทธิ์
煮	zhǔ	ปรุงอาหาร
注册	zhù cè	จดทะเบียน
祝福	zhù fú	พร
抓	zhuā	คว้า
抓紧	zhuā jǐn	ตั้งใจฟังให้ดี
专家	zhuān jiā	ผู้เชี่ยวชาญ
专心	zhuān xīn	สมาธิ
转变	zhuǎn biàn	เปลี่ยนแปลง
转告	zhuǎn gào	บอก
装	zhuāng	ติดตั้ง
装饰	zhuāng shì	การตกแต่ง
装修	zhuāng xiū	การตกแต่ง
撞	zhuàng	ตี
状况	zhuàng kuàng	สถานการณ์
状态	zhuàng tài	สถานะ
追	zhuī	ไล่ล่า
追求	zhuī qiú	ไล่ตาม
咨询	zī xún	ที่ปรึกษา
姿势	zī shì	ท่าทาง
资格	zī gé	คุณสมบัติ
资金	zī jīn	กองทุน
资料	zī liào	ข้อมูล
资源	zī yuán	ทรัพยากร
紫	zǐ	สีม่วง
字母	zì mǔ	จดหมาย
字幕	zì mù	คำบรรยาย
自从	zì cóng	ตั้งแต่
自动	zì dòng	อัตโนมัติ
自豪	zì háo	ความภาคภูมิใจ
自觉	zì jué	มีสติ
自私	zì sī	เห็นแก่ตัว
自由	zì yóu	ฟรี
自愿	zì yuàn	อาสาสมัคร
综合	zōng hé	ครอบคลุม
总裁	zǒng cái	ประธาน
总共	zǒng gòng	เบ็ดเสร็จ
总理	zǒng lǐ	นายกรัฐมนตรี
总算	zǒng suàn	สุดท้าย
总统	zǒng tǒng	ประธาน
总之	zǒng zhī	ในระยะสั้น
组	zǔ	กลุ่ม
组成	zǔ chéng	องค์ประกอบ
组合	zǔ hé	การรวมกัน
组织	zǔ zhī	องค์กร
阻止	zǔ zhǐ	ป้องกัน
最初	zuì chū	เริ่มต้น
醉	zuì	เมา
尊敬	zūn jìng	เคารพ
遵守	zūn shǒu	ปฏิบัติตาม
作品	zuò pǐn	ได้ผล
作为	zuò wéi	เช่น
作文	zuò wén	องค์ประกอบ
