挨	ái	苦しむ
癌症	ái zhèng	癌
暧昧	ài mèi	あいまい
爱不释手	ài bù shì shǒu	それを置く
爱戴	ài dài	愛する
安宁	ān níng	平和
安详	ān xiáng	穏やか
安置	ān zhì	配置
按摩	àn mó	マッサージ
暗示	àn shì	ヒント
案件	àn jiàn	場合
案例	àn lì	場合
昂贵	áng guì	高価な
凹凸	āo tū	バンプ
熬	áo	沸騰
奥秘	ào mì	神秘
巴不得	bā bù dé	気になる
巴结	bā jie	子鹿
扒	bā	グリル
疤	bā	傷跡
拔苗助长	bá miáo zhù zhǎng	根こそぎ
把关	bǎ guān	小切手
把手	bǎ shǒu	扱う
罢工	bà gōng	攻撃
霸道	bà dào	圧倒的
掰	bāi	さようなら
摆脱	bǎi tuō	取り除く
拜访	bài fǎng	訪問
拜年	bài nián	明けましておめでとうございます
拜托	bài tuō	お願いします
败坏	bài huài	破損している
斑	bān	スポット
颁布	bān bù	公布する
颁发	bān fā	問題
版本	bǎn běn	バージョン
伴侣	bàn lv3	コンパニオン
伴随	bàn suí	付随の
半途而废	bàn tú ér fèi	途中で諦める
扮演	bàn yǎn	演奏する
榜样	bǎng yàng	例
绑架	bǎng jià	誘拐
磅	bàng	ポンド
包庇	bāo bì	シェルター
包袱	bāo fu	負担
包围	bāo wéi	囲まれている
包装	bāo zhuāng	パッケージ
保管	bǎo guǎn	親権
保密	bǎo mì	秘密にしてください
保姆	bǎo mǔ	ベビーシッター
保守	bǎo shǒu	保守的
保卫	bǎo wèi	守る
保养	bǎo yǎng	メンテナンス
保障	bǎo zhàng	保証
保重	bǎo zhòng	気を付けて
饱和	bǎo hé	飽和
饱经沧桑	bǎo jīng cāng sāng	変遷
报酬	bào chou	報酬
报仇	bào chóu	復讐
报答	bào dá	返済
报复	bào fù	復讐
报警	bào jǐng	警察を呼ぶ
报销	bào xiāo	償還
抱负	bào fù	野心
暴力	bào lì	暴力
暴露	bào lù	露出
曝光	bào guāng	曝露
爆发	bào fā	起こる
爆炸	bào zhà	爆発
卑鄙	bēi bǐ	平均
悲哀	bēi āi	悲しみ
悲惨	bēi cǎn	悲劇的
北极	běi jí	北極
备份	bèi fèn	バックアップ
备忘录	bèi wàng lù	メモ
背叛	bèi pàn	裏切る
背诵	bèi sòng	叙述する
被动	bèi dòng	受動的
被告	bèi gào	被告
贝壳	bèi ké	シェル
奔波	bēn bō	走り回る
奔驰	bēn chí	ベンツ
本能	běn néng	本能
本钱	běn qián	資本
本人	běn rén	自分
本身	běn shēn	自体
本事	běn shi	能力
笨拙	bèn zhuō	不器用
崩溃	bēng kuì	崩壊
甭	béng	しないでください
蹦	bèng	ジャンプ
迸发	bèng fā	バースト
逼迫	bī pò	力
鼻涕	bí tì	鼻
比方	bǐ fang	例えば
比喻	bǐ yù	比喩
比重	bǐ zhòng	割合
鄙视	bǐ shì	軽蔑する
弊病	bì bìng	沈滞
弊端	bì duān	短所
臂	bì	腕
闭塞	bì sè	オクルード
编织	biān zhī	織り
边疆	biān jiāng	フロンティア
边界	biān jiè	境界
边境	biān jìng	境界
边缘	biān yuán	縁
鞭策	biān cè	拍車
扁	biǎn	平らな
贬低	biǎn dī	見くびる
贬义	biǎn yì	軽蔑的
便利	biàn lì	便利
便条	biàn tiáo	注意
便于	biàn yú	簡単に
变故	biàn gù	不幸
变迁	biàn qiān	変化する
变质	biàn zhì	腐敗
辨认	biàn rèn	識別する
辩护	biàn hù	守る
辩解	biàn jiě	言い訳
辩证	biàn zhèng	方言
辫子	biàn zi	編組
遍布	biàn bù	いたるところ
标本	biāo běn	検体
标记	biāo jì	マーク
标题	biāo tí	題名
表决	biǎo jué	投票
表态	biǎo tài	スタンス
表彰	biǎo zhāng	認識
憋	biē	控える
别墅	bié shù	ヴィラ
别致	bié zhì	シック
别扭	biè niu	ぎこちない
濒临	bīn lín	の危機に瀕して
冰雹	bīng báo	雹
丙	bǐng	c
并非	bìng fēi	ない
并列	bìng liè	並んで
剥削	bō xuē	悪用
拨	bō	ダイヤル
播种	bō zhòng	種まき
波浪	bō làng	波
波涛	bō tāo	波
伯母	bó mǔ	叔母
博大精深	bó dà jīng shēn	広くて深遠
博览会	bó lǎn huì	フェア
搏斗	bó dòu	戦い
薄弱	bó ruò	弱い
不顾	bú gù	かかわらず
不愧	bú kuì	価値がある
不料	bú liào	意外と
不像话	bú xiàng huà	とんでもない
不屑一顾	bú xiè yī gù	退ける
哺乳	bǔ rǔ	授乳
捕捉	bǔ zhuō	キャプチャー
补偿	bǔ cháng	化粧
补救	bǔ jiù	療法
补贴	bǔ tiē	補助金
不得已	bù dé yǐ	最後の手段
不妨	bù fáng	同様にかもしれない
不敢当	bù gǎn dāng	あえてしないでください
不禁	bù jīn	仕方がない
不堪	bù kān	たまらない
不可思议	bù kě sī yì	信じられない
不免	bù miǎn	必然的に
不时	bù shí	時々
不惜	bù xī	躊躇しない
不相上下	bù xiāng shàng xià	匹敵します
不言而喻	bù yán ér yù	それは言うまでもない
不由得	bù yóu de	仕方がない
不择手段	bù zé shǒu duàn	一生懸命遊べ
不止	bù zhǐ	より多い
布告	bù gào	通知
布局	bù jú	レイアウト
布置	bù zhì	レイアウト
步伐	bù fá	ペース
部署	bù shǔ	デプロイ
部位	bù wèi	ロケーション
才干	cái gàn	能力
裁缝	cái feng	テーラー
裁判	cái pàn	審判
裁员	cái yuán	解雇
财富	cái fù	富
财务	cái wù	ファイナンス
财政	cái zhèng	金融
彩票	cǎi piào	宝くじ
采购	cǎi gòu	購入
采集	cǎi jí	コレクション
采纳	cǎi nà	可決
参谋	cān móu	スタッフ
参照	cān zhào	参照
残疾	cán jí	障害
残酷	cán kù	残酷
残留	cán liú	残基
残忍	cán rěn	残酷
灿烂	càn làn	鮮やかさ
仓促	cāng cù	急いで
仓库	cāng kù	倉庫
舱	cāng	キャビン
苍白	cāng bái	淡い
操劳	cāo láo	一生懸命働く
操练	cāo liàn	練習
操纵	cāo zòng	操作する
操作	cāo zuò	オペレーティング
嘈杂	cáo zá	騒々しい
草案	cǎo àn	ドラフト
草率	cǎo shuài	急いで
侧面	cè miàn	側
测量	cè liáng	測定
策划	cè huà	予定
策略	cè lvè	戦略
层出不穷	céng chū bù qióng	エンドレス
层次	céng cì	レベル
差别	chā bié	差
插座	chā zuò	ソケット
查获	chá huò	押収
刹那	chà nà	瞬間
岔	chà	フォーク
诧异	chà yì	びっくり
柴油	chái yóu	ディーゼルオイル
搀	chān	ミックス
缠绕	chán rào	巻き取り
馋	chán	貪欲
产业	chǎn yè	業界
阐述	chǎn shù	手の込んだ
颤抖	chàn dǒu	震え
昌盛	chāng shèng	繁栄
偿还	cháng huán	返済
尝试	cháng shì	試してみてください
场合	chǎng hé	機会
场面	chǎng miàn	シーン
场所	chǎng suǒ	場所
敞开	chǎng kāi	大きく開く
倡导	chàng dǎo	提唱する
倡议	chàng yì	主導権
畅通	chàng tōng	ブロックを解除
畅销	chàng xiāo	ベスト・セラー
超越	chāo yuè	超えて
钞票	chāo piào	銀行券
嘲笑	cháo xiào	歯に詰め物をする
巢穴	cháo xué	ネスト
朝代	cháo dài	王朝
潮流	cháo liú	傾向
撤退	chè tuì	退却
撤销	chè xiāo	取り消す
沉淀	chén diàn	降水量
沉闷	chén mèn	鈍い
沉思	chén sī	瞑想
沉重	chén zhòng	ヘビー
沉着	chén zhuó	落ち着いて
陈旧	chén jiù	廃止
陈列	chén liè	表示
陈述	chén shù	ステートメント
称心如意	chèn xīn rú yì	満足できる
衬托	chèn tuō	出発する
称号	chēng hào	題名
乘	chéng	かける
呈现	chéng xiàn	プレゼント
城堡	chéng bǎo	城
惩罚	chéng fá	罰
成本	chéng běn	費用
成交	chéng jiāo	対処
成天	chéng tiān	一日中
成效	chéng xiào	効果
成心	chéng xīn	故意に
成员	chéng yuán	メンバー
承办	chéng bàn	引き受ける
承包	chéng bāo	契約する
承诺	chéng nuò	に専心して
橙	chéng	オレンジ
澄清	chéng qīng	明らかにする
盛	chéng	シェン
诚挚	chéng zhì	誠実
秤	chèng	スケール
吃苦	chī kǔ	苦しむ
吃力	chī lì	激しい
持久	chí jiǔ	持続する
迟钝	chí dùn	スロー
迟缓	chí huǎn	スロー
迟疑	chí yí	躊躇する
赤道	chì dào	赤道
赤字	chì zì	赤字
充当	chōng dāng	として作用します
充沛	chōng pèi	豊富
充实	chōng shí	エンリッチ
充足	chōng zú	適切
冲动	chōng dòng	インパルス
冲击	chōng jī	ショック
冲突	chōng tū	対立
崇拜	chóng bài	崇拝
崇高	chóng gāo	荘厳な
崇敬	chóng jìng	尊敬
重叠	chóng dié	重複
稠密	chóu mì	密集
筹备	chóu bèi	準備
丑恶	chǒu è	醜い
出路	chū lù	出口
出卖	chū mài	売る
出身	chū shēn	原点
出神	chū shén	トランス
出息	chū xi	未解決の
初步	chū bù	予備
除	chú	を除いて
储备	chǔ bèi	リザーブ
储存	chǔ cún	お店
储蓄	chǔ xù	節約
处分	chǔ fèn	制裁
处境	chǔ jìng	状況
处置	chǔ zhì	処分する
触犯	chù fàn	気分を害する
川流不息	chuān liú bù xī	一定のストリーム
穿越	chuān yuè	トラバース
传达	chuán dá	伝える
传单	chuán dān	チラシ
传授	chuán shòu	教える
船舶	chuán bó	輸送する
喘气	chuǎn qì	パンツ
串	chuàn	ストリング
床单	chuáng dān	ベッドシーツ
创立	chuàng lì	設立
创新	chuàng xīn	革新
创业	chuàng yè	ビジネスを始める
创作	chuàng zuò	創造
吹牛	chuī niú	自慢
吹捧	chuī pěng	よりフラット
炊烟	chuī yān	煙を調理する
垂直	chuí zhí	垂直
锤	chuí	ハンマー
纯粹	chún cuì	純粋に
纯洁	chún jié	ピュア
慈善	cí shàn	慈善
慈祥	cí xiáng	親切に
磁带	cí dài	テープ
雌雄	cí xióng	男性と女性
伺候	cì hòu	サーブ
刺	cì	とげ
次品	cì pǐn	欠陥品
次序	cì xù	注文
丛	cóng	塊
从容	cóng róng	落ち着いて
凑合	còu he	即興
粗鲁	cū lǔ	失礼
窜	cuàn	チャネル
摧残	cuī cán	荒廃
脆弱	cuì ruò	壊れやすい
搓	cuō	ねじれ
磋商	cuō shāng	相談
挫折	cuò zhé	欲求不満
搭	dā	取る
搭档	dā dàng	相棒
搭配	dā pèi	一致
答辩	dá biàn	応答
答复	dá fù	応答
达成	dá chéng	リーチ
打包	dǎ bāo	ベール
打官司	dǎ guān si	訴訟
打击	dǎ jī	ブロー
打架	dǎ jià	戦い
打量	dǎ liang	見る
打猎	dǎ liè	ハント
打仗	dǎ zhàng	戦い
大不了	dà bù liǎo	大したこと
大臣	dà chén	大臣
大伙儿	dà huǒ r	全員
大肆	dà sì	wantonly
大体	dà tǐ	一般に
大意	dà yì	本旨
大致	dà zhì	約
歹徒	dǎi tú	ギャングスター
代价	dài jià	費用
代理	dài lǐ	プロキシ
带领	dài lǐng	鉛
怠慢	dài màn	忘れる
逮捕	dài bǔ	逮捕
担保	dān bǎo	保証
胆怯	dǎn qiè	臆病
淡季	dàn jì	シーズンオフ
淡水	dàn shuǐ	淡水
蛋白质	dàn bái zhì	タンパク質
诞辰	dàn chén	お誕生日
诞生	dàn shēng	生まれ
当场	dāng chǎng	その場で
当初	dāng chū	初めに
当代	dāng dài	コンテンポラリー
当面	dāng miàn	面と向かって
当前	dāng qián	電流
当事人	dāng shì rén	パーティー
当务之急	dāng wù zhī jí	必須
当选	dāng xuǎn	選出
党	dǎng	パーティー
档案	dàng àn	ファイル
档次	dàng cì	グレード
倒闭	dǎo bì	崩壊
导弹	dǎo dàn	ミサイル
导航	dǎo háng	ナビゲーション
导向	dǎo xiàng	ガイド
捣乱	dǎo luàn	トラブルを起こします
盗窃	dào qiè	盗難
稻谷	dào gǔ	水田
得不偿失	dé bù cháng shī	失う価値はない
得力	dé lì	効果的
得天独厚	dé tiān dú hòu	祝福された
得罪	dé zuì	気分を害する
灯笼	dēng lóng	ランタン
登录	dēng lù	ログインする
登陆	dēng lù	サインイン
蹬	dēng	キック
等候	děng hòu	待っている
等级	děng jí	グレード
瞪	dèng	見詰める
堤坝	dī bà	ダム
敌视	dí shì	敵対的
抵达	dǐ dá	到着
抵抗	dǐ kàng	抵抗
抵制	dǐ zhì	抵抗する
地步	dì bù	ポイント
地势	dì shì	地形
地质	dì zhì	地質学
递增	dì zēng	増加する
颠簸	diān bǒ	バンプ
颠倒	diān dǎo	逆行する
典礼	diǎn lǐ	式
典型	diǎn xíng	典型的な
点缀	diǎn zhuì	装飾
垫	diàn	パッド
奠定	diàn dìng	レイ
惦记	diàn jì	心配して
电源	diàn yuán	電源
叼	diāo	ぶら下がり
雕刻	diāo kè	彫刻
雕塑	diāo sù	彫刻
吊	diào	ハング
调动	diào dòng	動員
跌	diē	秋
丁	dīng	丁
叮嘱	dīng zhǔ	勧める
盯	dīng	見詰める
定期	dìng qī	レギュラー
定义	dìng yì	定義
丢人	diū rén	恥
丢三落四	diū sān là sì	すべてを失う
东道主	dōng dào zhǔ	ホスト
东张西望	dōng zhāng xī wàng	周りを探し
董事长	dǒng shì zhǎng	委員長
冻结	dòng jié	氷結
动荡	dòng dàng	混乱
动机	dòng jī	動機
动静	dòng jìng	移動
动力	dòng lì	パワー
动脉	dòng mài	動脈
动身	dòng shēn	去る
动手	dòng shǒu	ハンズオン
动态	dòng tài	動的
动员	dòng yuán	動員
栋	dòng	ドン
兜	dōu	ポケット
陡峭	dǒu qiào	急勾配の
斗争	dòu zhēng	闘争
督促	dū cù	衝動
毒品	dú pǐn	薬
独裁	dú cái	独裁
堵塞	dǔ sè	閉塞
赌博	dǔ bó	ギャンブル
杜绝	dù jué	に終止符を打つ
端	duān	終わり
端午节	duān wǔ jié	ドラゴンボートフェスティバル
端正	duān zhèng	正しい
短促	duǎn cù	ショート
断定	duàn dìng	決定する
断绝	duàn jué	を中断する
堆积	duī jī	累積
兑现	duì xiàn	現金
对策	duì cè	対策
对称	duì chèn	対称
对付	duì fu	扱う
对抗	duì kàng	対決
对立	duì lì	反対
对联	duì lián	カプレット
对应	duì yìng	一致する
对照	duì zhào	コントロール
队伍	duì wu	チーム
顿时	dùn shí	突然
哆嗦	duō suo	震え
多元化	duō yuán huà	多様化
堕落	duò luò	堕落した
额外	é wài	追加
恶心	ě xin	吐き気
恶化	è huà	劣化
遏制	è zhì	含む
恩怨	ēn yuàn	恨み
而已	ér yǐ	それでおしまい
二氧化碳	èr yǎng huà tàn	二酸化炭素
发布	fā bù	リリース
发财	fā cái	裕福になる
发呆	fā dāi	眩惑
发动	fā dòng	打ち上げ
发觉	fā jué	見つける
发射	fā shè	排出量
发誓	fā shì	誓う
发行	fā xíng	発行済み
发炎	fā yán	熱
发扬	fā yáng	繰り越す
发育	fā yù	開発
法人	fǎ rén	法人
番	fān	ファン
凡是	fán shì	すべて
繁华	fán huá	にぎやか
繁忙	fán máng	忙しい
繁体字	fán tǐ zì	繁体字中国語
繁殖	fán zhí	繁殖
反驳	fǎn bó	反論
反常	fǎn cháng	異常な
反感	fǎn gǎn	嫌い
反抗	fǎn kàng	反乱
反馈	fǎn kuì	フィードバック
反面	fǎn miàn	負
反射	fǎn shè	反射
反思	fǎn sī	反射
反问	fǎn wèn	修辞的な質問
反之	fǎn zhī	それどころか
泛滥	fàn làn	洪水
范畴	fàn chóu	カテゴリー
贩卖	fàn mài	売る
方位	fāng wèi	ポジション
方言	fāng yán	方言
方圆	fāng yuán	fangyuan
方针	fāng zhēn	ポリシー
防守	fáng shǒu	防御的
防御	fáng yù	防衛
防止	fáng zhǐ	防ぐ
防治	fáng zhì	コントロール
纺织	fǎng zhī	繊維
访问	fǎng wèn	アクセス
放大	fàng dà	拡大
放射	fàng shè	放射線
非法	fēi fǎ	違法
飞禽走兽	fēi qín zǒu shòu	鳥と獣
飞翔	fēi xiáng	飛ぶ
飞跃	fēi yuè	飛躍
肥沃	féi wò	肥沃な
诽谤	fěi bàng	名誉毀損
废除	fèi chú	廃止
废寝忘食	fèi qǐn wàng shí	眠れない
废墟	fèi xū	廃墟
沸腾	fèi téng	沸騰
肺	fèi	肺
分辨	fēn biàn	区別する
分寸	fēn cun	対策
分红	fēn hóng	配当
分解	fēn jiě	壊す
分裂	fēn liè	スプリット
分泌	fēn mì	分泌
分明	fēn míng	明確な
分歧	fēn qí	不一致
分散	fēn sàn	分散
吩咐	fēn fù	注文
坟墓	fén mù	墓
粉末	fěn mò	パウダー
粉色	fěn sè	ピンク
粉碎	fěn suì	スマッシュ
分量	fèn liàng	部分
愤怒	fèn nù	怒り
丰满	fēng mǎn	フル
丰盛	fēng shèng	リッチ
丰收	fēng shōu	バンパーハーベスト
封闭	fēng bì	閉まっている
封建	fēng jiàn	確執
封锁	fēng suǒ	封鎖
锋利	fēng lì	シャープ
风暴	fēng bào	嵐
风度	fēng dù	物腰
风光	fēng guāng	風景
风气	fēng qì	雰囲気
风趣	fēng qù	おかしい
风土人情	fēng tǔ rén qíng	地元の習慣
风味	fēng wèi	フレーバー
逢	féng	すべて
奉献	fèng xiàn	献身
否决	fǒu jué	拒否
夫妇	fū fù	カップル
夫人	fū ren	レディ
敷衍	fū yǎn	いいかげんな
俘虏	fú lǔ	捕虜
幅度	fú dù	振幅
服从	fú cóng	従う
服气	fú qì	納得
福利	fú lì	福祉
福气	fú qi	祝福
符号	fú hào	シンボル
辐射	fú shè	放射線
俯视	fǔ shì	見下ろして
抚摸	fǔ mō	撫でる
抚养	fǔ yǎng	上げる
腐败	fǔ bài	腐敗
腐烂	fǔ làn	腐敗
腐蚀	fǔ shí	腐食
腐朽	fǔ xiǔ	減衰
辅助	fǔ zhù	支援する
副	fù	副
复活	fù huó	復活
复兴	fù xīng	復活
富裕	fù yù	リッチ
腹泻	fù xiè	下痢
覆盖	fù gài	カバー
负担	fù dān	負担
赋予	fù yǔ	与える
附和	fù hè	一緒に行く
附件	fù jiàn	別館
附属	fù shǔ	添付
改良	gǎi liáng	改善する
盖章	gài zhāng	切手
钙	gài	カルシウム
尴尬	gān gà	ぎこちない
干旱	gān hàn	干ばつ
干扰	gān rǎo	干渉
干涉	gān shè	余計な世話を焼く
干预	gān yù	介入
感慨	gǎn kǎi	はぁ
感染	gǎn rǎn	感染
干劲	gàn jìn	熱意
扛	gāng	運ぶ
纲领	gāng lǐng	プログラム
岗位	gǎng wèi	役職
港口	gǎng kǒu	ポート
港湾	gǎng wān	港
杠杆	gàng gǎn	レバー
高超	gāo chāo	見事
高潮	gāo cháo	クライマックス
高峰	gāo fēng	ピーク
高明	gāo míng	賢い
高尚	gāo shàng	ノーブル
高涨	gāo zhǎng	急上昇
稿件	gǎo jiàn	原稿
告辞	gào cí	お別れ
告诫	gào jiè	忠告する
割	gē	切る
搁	gē	置く
歌颂	gē sòng	賞賛
疙瘩	gē da	ピンプル
鸽子	gē zi	鳩
格局	gé jú	パターン
格式	gé shì	フォーマット
隔阂	gé hé	ギャップ
隔离	gé lí	隔離
革命	gé mìng	革命
个体	gè tǐ	個人
各抒己见	gè shū jǐ jiàn	彼らの意見を表明する
根深蒂固	gēn shēn dì gù	染み込んだ
根源	gēn yuán	ソース
跟前	gēn qián	の前に
跟随	gēn suí	フォローする
跟踪	gēn zōng	追跡
更新	gēng xīn	更新
更正	gēng zhèng	正しい
耕地	gēng dì	耕地
供不应求	gōng bù yìng qiú	不足して
供给	gōng jǐ	供給
公安局	gōng ān jú	公安局
公道	gōng dào	正義
公告	gōng gào	発表
公关	gōng guān	pr
公民	gōng mín	市民
公然	gōng rán	公然と
公认	gōng rèn	受け入れられました
公式	gōng shì	式
公务	gōng wù	公務
公正	gōng zhèng	ただ
公证	gōng zhèng	公証
功劳	gōng láo	クレジット
功效	gōng xiào	効果
宫殿	gōng diàn	宮殿
工艺品	gōng yì pǐn	工芸品
恭敬	gōng jìng	敬意を表する
攻击	gōng jī	攻撃
攻克	gōng kè	キャプチャー
巩固	gǒng gù	統合
共和国	gòng hé guó	共和国
共计	gòng jì	合計
共鸣	gòng míng	共振
勾结	gōu jié	衝突する
钩子	gōu zi	針
构思	gòu sī	考え
姑且	gū qiě	とりあえず
孤独	gū dú	寂しい
孤立	gū lì	孤立
辜负	gū fù	失望させる
古董	gǔ dǒng	アンティーク
古怪	gǔ guài	エキセントリック
股东	gǔ dōng	株主
股份	gǔ fèn	共有
骨干	gǔ gàn	背骨
鼓动	gǔ dòng	かき混ぜる
固然	gù rán	もちろん
固体	gù tǐ	固体
固有	gù yǒu	固有
固执	gù zhi	頑固
故乡	gù xiāng	ホーム
故障	gù zhàng	故障
雇佣	gù yōng	雇う
顾虑	gù lv4	懸念
顾问	gù wèn	コンサルタント
拐杖	guǎi zhàng	松葉杖
关怀	guān huái	ケア
关照	guān zhào	ケア
官方	guān fāng	公式
观光	guān guāng	観光に行く
管辖	guǎn xiá	管轄
惯例	guàn lì	コンベンション
灌溉	guàn gài	灌漑
罐	guàn	タンク
贯彻	guàn chè	実装する
光彩	guāng cǎi	栄光
光辉	guāng huī	栄光
光芒	guāng máng	光
光荣	guāng róng	栄光
广阔	guǎng kuò	広い
归根到底	guī gēn dào dǐ	最終的な分析では
归还	guī huán	戻る
规范	guī fàn	仕様
规格	guī gé	仕様
规划	guī huà	計画
规章	guī zhāng	規則
轨道	guǐ dào	追跡
贵族	guì zú	ノーブル
跪	guì	ひざまずく
棍棒	gùn bàng	スティック
国防	guó fáng	国防
国务院	guó wù yuàn	国務院
果断	guǒ duàn	決定的
过度	guò dù	以上
过渡	guò dù	遷移
过奖	guò jiǎng	過大評価
过滤	guò lv4	フィルタ
过失	guò shī	障害
过问	guò wèn	介入する
过瘾	guò yǐn	楽しい
过于	guò yú	あまりにも
嗨	hāi	こんにちは
海拔	hǎi bá	高度
海滨	hǎi bīn	シーサイド
含糊	hán hu	漠然とした
含义	hán yì	意味
寒暄	hán xuān	挨拶
罕见	hǎn jiàn	レア
捍卫	hàn wèi	守る
航空	háng kōng	航空
航天	háng tiān	航空宇宙
航行	háng xíng	セーリング
行列	háng liè	ランク
毫米	háo mǐ	んん
毫无	háo wú	何もない
豪迈	háo mài	ヒロイック
号召	hào zhào	呼び掛ける
耗费	hào fèi	費用
呵	hē	ああ
合并	hé bìng	マージ
合成	hé chéng	合成
合伙	hé huǒ	パートナーシップ
合算	hé suàn	費用対効果
和蔼	hé ǎi	種類
和解	hé jiě	和解
和睦	hé mù	調和
和气	hé qi	親切
和谐	hé xié	調和のとれた
嘿	hēi	ねえ
痕迹	hén jì	痕跡
狠心	hěn xīn	無情
恨不得	hèn bu dé	待てない
哼	hēng	ハンフ
横	héng	水平
哄	hōng	同軸
烘	hōng	焼く
轰动	hōng dòng	感覚
宏观	hóng guān	大きい
宏伟	hóng wěi	壮大
洪水	hóng shuǐ	洪水
喉咙	hóu lóng	喉
吼	hǒu	咆哮
候选	hòu xuǎn	候補者
后代	hòu dài	子孫
后顾之忧	hòu gù zhī yōu	心配
后勤	hòu qín	ロジスティクス
呼唤	hū huàn	コール
呼啸	hū xiào	遠吠え
呼吁	hū yù	コール
忽略	hū lvè	無視する
湖泊	hú pō	湖
胡乱	hú luàn	さりげなく
胡须	hú xū	あごひげ
花瓣	huā bàn	花弁
花蕾	huā lěi	つぼみ
华丽	huá lì	ゴージャス
华侨	huá qiáo	華僑
划分	huà fēn	分割する
化肥	huà féi	肥料
化石	huà shí	化石
化验	huà yàn	アッセイ
化妆	huà zhuāng	化粧
画蛇添足	huà shé tiān zú	余計な
话筒	huà tǒng	マイクロフォン
欢乐	huān lè	喜び
环节	huán jié	リンク
还原	huán yuán	削減
缓和	huǎn hé	簡易
患者	huàn zhě	患者
荒凉	huāng liáng	荒涼とした
荒谬	huāng miù	ばかげている
荒唐	huāng táng	ばかげている
皇帝	huáng dì	天皇
皇后	huáng hòu	女王
黄昏	huáng hūn	夕暮れ
恍然大悟	huǎng rán dà wù	いきなり気づいた
晃	huǎng	振る
挥霍	huī huò	splurge
辉煌	huī huáng	鮮やかさ
回报	huí bào	戻る
回避	huí bì	避ける
回顾	huí gù	レビュー
回收	huí shōu	リサイクル
悔恨	huǐ hèn	悔い改め
毁灭	huǐ miè	破壊
会晤	huì wù	会議
汇报	huì bào	報告書
贿赂	huì lù	賄賂
昏迷	hūn mí	昏睡
荤	hūn	お肉
浑身	hún shēn	いたるところ
混合	hùn hé	混合
混乱	hùn luàn	錯乱
混淆	hùn xiáo	混乱させる
混浊	hùn zhuó	濁った
活该	huó gāi	それに値する
活力	huó lì	活力
火箭	huǒ jiàn	ロケット
火焰	huǒ yàn	火炎
火药	huǒ yào	火薬
货币	huò bì	通貨
基地	jī dì	ベース
基金	jī jīn	基金
基因	jī yīn	遺伝子
机动	jī dòng	マニューバ
机构	jī gòu	機構
机灵	jī ling	賢い
机密	jī mì	機密
机械	jī xiè	機械的
机遇	jī yù	機会
机智	jī zhì	機知に富んだ
激发	jī fā	励起
激励	jī lì	励起
激情	jī qíng	情熱
讥笑	jī xiào	冷笑
饥饿	jī è	飢え
即便	jí biàn	たとえ
即将	jí jiāng	近日公開
及早	jí zǎo	早い
吉祥	jí xiáng	縁起の良い
嫉妒	jí dù	嫉妬
急功近利	jí gōng jìn lì	迅速な成功
急剧	jí jù	シャープ
急切	jí qiè	熱心な
急于求成	jí yú qiú chéng	成功への熱意
急躁	jí zào	せっかち
极端	jí duān	極端
极限	jí xiàn	制限
疾病	jí bìng	疾患
籍贯	jí guàn	出身地
级别	jí bié	レベル
集团	jí tuán	グループ
给予	jǐ yǔ	与える
季军	jì jūn	第三位
季度	jì dù	四半期ごと
寂静	jì jìng	沈黙
寄托	jì tuō	委託する
忌讳	jì huì	タブー
技巧	jì qiǎo	スキル
纪要	jì yào	概要
继承	jì chéng	継承
计较	jì jiào	気にする
记性	jì xing	メモリ
记载	jì zǎi	記録
迹象	jì xiàng	符号
佳肴	jiā yáo	繊細さ
加工	jiā gōng	処理
加剧	jiā jù	強化する
夹杂	jiā zá	包含
家常	jiā cháng	家庭的な
家伙	jiā huo	男
家属	jiā shǔ	家族のメンバー
家喻户晓	jiā yù hù xiǎo	よく知られている
坚定	jiān dìng	当社
坚固	jiān gù	当社
坚韧	jiān rèn	タフ
坚实	jiān shí	固体
坚硬	jiān yìng	ハード
尖端	jiān duān	ヒント
尖锐	jiān ruì	シャープ
煎	jiān	揚げ
监督	jiān dū	監督する
监视	jiān shì	モニター
监狱	jiān yù	刑務所
艰难	jiān nán	難しい
剪彩	jiǎn cǎi	リボンを切る
拣	jiǎn	ピック
检讨	jiǎn tǎo	レビュー
检验	jiǎn yàn	テスト
简化	jiǎn huà	簡素化する
简陋	jiǎn lòu	粗雑
简体字	jiǎn tǐ zì	簡略化された中国語
简要	jiǎn yào	簡単な
健全	jiàn quán	音
剑	jiàn	剣
溅	jiàn	スプラッシュ
舰艇	jiàn tǐng	輸送する
见多识广	jiàn duō shí guǎng	知識がある
见解	jiàn jiě	意見
见闻	jiàn wén	知識
见义勇为	jiàn yì yǒng wéi	正当化する
践踏	jiàn tà	トランプル
鉴别	jiàn bié	識別する
鉴定	jiàn dìng	識別
鉴于	jiàn yú	与えられた
间谍	jiàn dié	スパイ
间隔	jiàn gé	間隔
间接	jiàn jiē	間接
僵硬	jiāng yìng	硬い
将军	jiāng jūn	一般
将近	jiāng jìn	ほぼ
将就	jiāng jiù	になります
奖励	jiǎng lì	褒賞
奖赏	jiǎng shǎng	褒賞
桨	jiǎng	パドル
降临	jiàng lín	来て
交叉	jiāo chā	クロス
交代	jiāo dài	説明する
交涉	jiāo shè	ネゴシエーション
交易	jiāo yì	トランザクション
娇气	jiāo qì	きしむ
焦点	jiāo diǎn	フォーカス
焦急	jiāo jí	気になる
侥幸	jiǎo xìng	幸運な
搅拌	jiǎo bàn	かき混ぜる
缴纳	jiǎo nà	支払う
角落	jiǎo luò	コーナー
教养	jiào yǎng	育成
较量	jiào liàng	コンテスト
接连	jiē lián	選び出す
揭露	jiē lù	公開する
皆	jiē	すべて
阶层	jiē céng	クラス
截止	jié zhǐ	を中断する
截至	jié zhì	現在
杰出	jié chū	未解決の
竭尽全力	jié jìn quán lì	がんばってね
结晶	jié jīng	結晶
结局	jié jú	エンディング
结算	jié suàn	決済
节制	jié zhì	コントロール
节奏	jié zòu	リズム
解除	jiě chú	退出させる
解放	jiě fàng	解放
解雇	jiě gù	解任
解剖	jiě pōu	解剖学
解散	jiě sàn	解散
解体	jiě tǐ	崩壊
借鉴	jiè jiàn	かりて
借助	jiè zhù	の助けを借りて
戒备	jiè bèi	アラート
界限	jiè xiàn	制限
津津有味	jīn jīn yǒu wèi	味わいあり
金融	jīn róng	金融
紧迫	jǐn pò	緊急
锦上添花	jǐn shàng tiān huā	ケーキの上のアイシング
晋升	jìn shēng	プロモーション
浸泡	jìn pào	浸す
近来	jìn lái	最近
进而	jìn ér	その後
进攻	jìn gōng	攻撃
进化	jìn huà	進化
进展	jìn zhǎn	進捗
兢兢业业	jīng jīng yè yè	良心的
惊动	jīng dòng	乱す
惊奇	jīng qí	驚き
惊讶	jīng yà	びっくり
精打细算	jīng dǎ xì suàn	慎重に計画する
精华	jīng huá	エッセンス
精简	jīng jiǎn	合理化
精密	jīng mì	精度
精确	jīng què	正確
精通	jīng tōng	熟練している
精心	jīng xīn	手の込んだ
精益求精	jīng yì qiú jīng	改善し続ける
精致	jīng zhì	絶妙な
经费	jīng fèi	資金調達
经纬	jīng wěi	緯度と経度
茎	jīng	幹
井	jǐng	上手
警告	jǐng gào	警告
警惕	jǐng tì	アラート
颈椎	jǐng zhuī	頸椎
境界	jìng jiè	レルム
敬礼	jìng lǐ	敬礼
敬业	jìng yè	ひたむきな
竞赛	jìng sài	コンペ
竞选	jìng xuǎn	運動
镜头	jìng tóu	レンズ
纠纷	jiū fēn	紛争
纠正	jiū zhèng	正しい
酒精	jiǔ jīng	アルコール
就近	jiù jìn	近所の
就业	jiù yè	雇用
就职	jiù zhí	発足
救济	jiù jì	救済
居民	jū mín	住民
居住	jū zhù	住む
拘留	jū liú	拘留
拘束	jū shù	拘束
鞠躬	jū gōng	弓
局部	jú bù	部分的
局面	jú miàn	状況
局势	jú shì	状況
局限	jú xiàn	制限事項
举动	jǔ dòng	移動する
举世瞩目	jǔ shì zhǔ mù	世界的な注目を集める
举足轻重	jǔ zú qīng zhòng	極めて重要
咀嚼	jǔ jué	噛む
沮丧	jǔ sàng	欲求不満
剧本	jù běn	脚本
剧烈	jù liè	重度
据悉	jù xī	報告されている
聚精会神	jù jīng huì shén	集中
卷	juǎn	ボリューム
倔强	jué jiàng	頑固
决策	jué cè	意思決定
绝望	jué wàng	絶望
觉悟	jué wù	意識
觉醒	jué xǐng	目覚め
军队	jūn duì	軍
君子	jūn zǐ	紳士
卡通	kǎ tōng	漫画
开采	kāi cǎi	マイニング
开除	kāi chú	追放
开阔	kāi kuò	開いた
开朗	kāi lǎng	陽気な
开明	kāi míng	悟りを開いた
开辟	kāi pì	開く
开拓	kāi tuò	開く
开展	kāi zhǎn	発展させる
开支	kāi zhī	支出
刊登	kān dēng	公開
刊物	kān wù	出版
勘探	kān tàn	探査
侃侃而谈	kǎn kǎn ér tán	自由に話す
砍伐	kǎn fá	伐採
看待	kàn dài	見る
慷慨	kāng kǎi	寛大な
抗议	kàng yì	抗議
考察	kǎo chá	調査
考古	kǎo gǔ	考古学
考核	kǎo hé	評価
考验	kǎo yàn	テスト
靠拢	kào lǒng	近寄って
磕	kē	ノック
科目	kē mù	件名
可观	kě guān	かなりの
可口	kě kǒu	おいしい
可恶	kě wù	嫌い
可行	kě xíng	実行可能
渴望	kě wàng	欲望
克制	kè zhì	拘束
刻不容缓	kè bù róng huǎn	遅らせる時間はありません
客户	kè hù	クライアント
课题	kè tí	件名
啃	kěn	一口
恳切	kěn qiè	誠実
坑	kēng	ピット
空洞	kōng dòng	中空
空前绝后	kōng qián jué hòu	前例のない
空想	kōng xiǎng	ファンタジー
空虚	kōng xū	空虚
孔	kǒng	穴
恐怖	kǒng bù	テロ
恐吓	kǒng hè	威嚇する
恐惧	kǒng jù	恐れ
空白	kòng bái	ブランク
空隙	kòng xì	ギャップ
口气	kǒu qì	トーン
口腔	kǒu qiāng	口腔
口头	kǒu tóu	オーラル
口音	kǒu yīn	アクセント
扣	kòu	バックル
哭泣	kū qì	泣く
枯萎	kū wěi	枯れた
枯燥	kū zào	鈍い
苦尽甘来	kǔ jìn gān lái	苦味
苦涩	kǔ sè	苦い
挎	kuà	運ぶ
跨	kuà	スパン
快活	kuài huo	ハッピー
宽敞	kuān chang	広々とした
宽容	kuān róng	耐性
款待	kuǎn dài	おもてなし
款式	kuǎn shì	スタイル
筐	kuāng	バスケット
况且	kuàng qiě	その上
旷课	kuàng kè	欠勤
框架	kuàng jià	フレーム
矿产	kuàng chǎn	ミネラル
亏待	kuī dài	ひどく扱う
亏损	kuī sǔn	損失
捆绑	kǔn bǎng	縛られた
扩充	kuò chōng	拡張
扩散	kuò sàn	拡散
扩张	kuò zhāng	拡張
啦	lā	ラ
喇叭	lǎ ba	スピーカー
蜡烛	là zhú	キャンドル
来历	lái lì	原点
来源	lái yuán	ソース
栏目	lán mù	カラム
懒惰	lǎn duò	怠惰な
狼狈	láng bèi	恥ずかしい
狼吞虎咽	láng tūn hǔ yàn	狼
捞	lāo	魚
唠叨	láo dao	しつこい
牢固	láo gù	当社
牢骚	láo sāo	不平を言う
乐趣	lè qù	喜び
乐意	lè yì	喜んで
雷达	léi dá	レーダー
类似	lèi sì	同様
冷酷	lěng kù	残酷
冷落	lěng luò	省略
冷却	lěng què	クールダウン
愣	lèng	凍結
黎明	lí míng	夜明け
理睬	lǐ cǎi	注意を払う
理所当然	lǐ suǒ dāng rán	もちろん
理直气壮	lǐ zhí qì zhuàng	簡単
理智	lǐ zhì	理由
礼节	lǐ jié	エチケット
礼尚往来	lǐ shàng wǎng lái	互恵性
里程碑	lǐ chéng bēi	マイルストーン
例外	lì wài	例外
利害	lì hài	ステーク
力求	lì qiú	に努めています
力所能及	lì suǒ néng jí	私たちの力の中で
力争	lì zhēng	努力する
历代	lì dài	歴史
历来	lì lái	常に
立场	lì chǎng	ポジション
立方	lì fāng	キューブ
立交桥	lì jiāo qiáo	高架
立体	lì tǐ	三次元
立足	lì zú	立つ
粒	lì	粒
廉洁	lián jié	掃除
联欢	lián huān	集まる
联络	lián luò	接続
联盟	lián méng	アライアンス
联想	lián xiǎng	レノボ
连年	lián nián	毎年毎年
连锁	lián suǒ	鎖
连同	lián tóng	一緒に
良心	liáng xīn	良心
晾	liàng	空気
谅解	liàng jiě	理解
辽阔	liáo kuò	広大
列举	liè jǔ	列挙する
临床	lín chuáng	臨床
淋	lín	シャワー
吝啬	lìn sè	けち
伶俐	líng lì	スマート
凌晨	líng chén	朝早く
灵感	líng gǎn	インスピレーション
灵魂	líng hún	魂
灵敏	líng mǐn	敏感
零星	líng xīng	散発的
领会	lǐng huì	理解する
领事馆	lǐng shì guǎn	領事館
领土	lǐng tǔ	地域
领悟	lǐng wù	理解する
领先	lǐng xiān	鉛
领袖	lǐng xiù	盟主
溜	liū	スリップ
流浪	liú làng	さまよう
流露	liú lù	明らかにする
流氓	liú máng	不正
流通	liú tōng	サーキュレーション
留恋	liú liàn	懐かしさ
留念	liú niàn	お土産
留神	liú shén	気を付けて
聋哑	lóng yǎ	聾唖
隆重	lóng zhòng	グランド
垄断	lǒng duàn	独占
笼罩	lǒng zhào	シュラウド
搂	lǒu	抱擁
炉灶	lú zào	ストーブ
轮船	lún chuán	汽船
轮廓	lún kuò	輪郭
轮胎	lún tāi	タイヤ
论坛	lùn tán	フォーラム
论证	lùn zhèng	引数
啰唆	luō suo	迷惑
络绎不绝	luò yì bù jué	エンドレスストリーム
落成	luò chéng	完了
落实	luò shí	実装する
屡次	lv3 cì	繰り返し
履行	lv3 xíng	満たす
掠夺	lvè duó	略奪
嘛	ma	上手
麻痹	má bì	麻痺
麻木	má mù	しびれ
麻醉	má zuì	麻酔
码头	mǎ tóu	橋脚
蚂蚁	mǎ yǐ	蟻
埋伏	mái fú	待ち伏せ
埋没	mái mò	埋葬
埋葬	mái zàng	埋め込む
脉搏	mài bó	パルス
迈	mài	ステップ
埋怨	mán yuàn	不平を言う
慢性	màn xìng	慢性
漫长	màn cháng	長いです
漫画	màn huà	漫画
蔓延	màn yán	拡大
忙碌	máng lù	忙しい
盲目	máng mù	盲目的に
茫茫	máng máng	広大
茫然	máng rán	途方に暮れて
冒充	mào chōng	なりすまし
冒犯	mào fàn	気分を害する
茂盛	mào shèng	繁栄する
媒介	méi jiè	中
枚	méi	ピース
美观	měi guān	綺麗な
美满	měi mǎn	ハッピー
美妙	měi miào	素晴らしい
萌芽	méng yá	つぼみ
猛烈	měng liè	暴力的
眯	mī	斜視
弥补	mí bǔ	化粧
弥漫	mí màn	びまん性
谜语	mí yǔ	謎
迷惑	mí huo	混乱させる
迷人	mí rén	魅力的
迷信	mí xìn	迷信
密度	mì dù	密度
密封	mì fēng	密閉する
棉花	mián hua	コットン
免得	miǎn de	しないように
免疫	miǎn yì	免疫
勉励	miǎn lì	奨励します
勉强	miǎn qiǎng	しぶしぶ
面貌	miàn mào	面
面子	miàn zi	面
描绘	miáo huì	描写
瞄准	miáo zhǔn	目的
渺小	miǎo xiǎo	小さい
藐视	miǎo shì	軽蔑
灭亡	miè wáng	滅びる
蔑视	miè shì	軽蔑
民间	mín jiān	フォーク
民主	mín zhǔ	民主主義
敏捷	mǐn jié	アジャイル
敏锐	mǐn ruì	鋭い
名次	míng cì	ランキング
名额	míng é	クォータ
名副其实	míng fù qí shí	名前に値する
名誉	míng yù	評判
明明	míng míng	明らかに
明智	míng zhì	賢い
命名	mìng míng	名前
摸索	mō suo	模索
摩擦	mó cā	摩擦
模范	mó fàn	モデル
模式	mó shì	モード
模型	mó xíng	モデル
磨合	mó hé	慣らし運転
膜	mó	膜
魔鬼	mó guǐ	悪魔
魔术	mó shù	魔法
抹杀	mǒ shā	抹消する
墨水儿	mò shuǐ r	インク
莫名其妙	mò míng qí miào	困惑
默默	mò mò	静かに
谋求	móu qiú	求める
模样	mú yàng	外観
母语	mǔ yǔ	母国語
沐浴	mù yù	入浴
目睹	mù dǔ	証人
目光	mù guāng	見て
拿手	ná shǒu	良い
纳闷儿	nà mèn r	不思議に思う
耐用	nài yòng	耐久性
南辕北辙	nán yuán běi zhé	発散
难得	nán dé	レア
难堪	nán kān	恥ずかしい
难能可贵	nán néng kě guì	称賛に値する
恼火	nǎo huǒ	イライラする
内涵	nèi hán	意味
内幕	nèi mù	裏話
内在	nèi zài	内側
能量	néng liàng	エネルギー
拟定	nǐ dìng	作成する
逆行	nì xíng	逆行
年度	nián dù	年
捏	niē	ピンチ
凝固	níng gù	凝固
凝聚	níng jù	凝集
凝视	níng shì	視線
拧	níng	スクリュー
宁肯	nìng kěn	むしろ
宁愿	nìng yuàn	むしろ
扭转	niǔ zhuǎn	ねじれ
纽扣儿	niǔ kòu r	ボタン
农历	nóng lì	太陰暦
浓厚	nóng hòu	強い
奴隶	nú lì	奴隷
挪	nuó	移動する
虐待	nvè dài	乱用
哦	ò	ああ
殴打	ōu dǎ	ビート
偶像	ǒu xiàng	アイドル
呕吐	ǒu tù	嘔吐
趴	pā	横たわる
徘徊	pái huái	さまよう
排斥	pái chì	撃退
排除	pái chú	除外する
排放	pái fàng	排出量
排练	pái liàn	リハーサル
派别	pài bié	派
派遣	pài qiǎn	送信
攀登	pān dēng	ザ・クライム
盘旋	pán xuán	旋回
判决	pàn jué	判定
畔	pàn	バンク
庞大	páng dà	巨大な
抛弃	pāo qì	放棄する
泡沫	pào mò	フォーム
培育	péi yù	育成
配备	pèi bèi	装備
配偶	pèi ǒu	配偶者
配套	pèi tào	マッチング
盆地	pén dì	たらい
烹饪	pēng rèn	料理
捧	pěng	ホールド
劈	pī	ハック
批发	pī fā	卸売
批判	pī pàn	批判
疲惫	pí bèi	疲れ果てた
疲倦	pí juàn	疲れた
皮革	pí gé	レザー
屁股	pì gu	お尻
譬如	pì rú	例えば
偏差	piān chā	偏差
偏见	piān jiàn	バイアス
偏僻	piān pì	リモート
偏偏	piān piān	それどころか
片断	piàn duàn	断片
片刻	piàn kè	瞬間
漂浮	piāo fú	浮く
飘扬	piāo yáng	フラッター
撇	piē	スキミング
拼搏	pīn bó	ハードワーク
拼命	pīn mìng	必死に
贫乏	pín fá	貧しい
贫困	pín kùn	貧しい
频繁	pín fán	頻繁に
频率	pín lv4	周波数
品尝	pǐn cháng	味
品德	pǐn dé	キャラクター
品质	pǐn zhì	品質
品种	pǐn zhǒng	バラエティ
屏幕	píng mù	画面
屏障	píng zhàng	バリア
平凡	píng fán	普通
平面	píng miàn	平らな
平坦	píng tǎn	平らな
平行	píng xíng	平行
平庸	píng yōng	平凡
平原	píng yuán	プレーン
评估	píng gū	評価
评论	píng lùn	コメント
坡	pō	スロープ
泼	pō	スプラッシュ
颇	pō	かなり
破例	pò lì	例外を作る
迫不及待	pò bù jí dài	待てない
迫害	pò hài	迫害
魄力	pò lì	勇気
扑	pū	はためく
铺	pū	ショップ
普及	pǔ jí	ユニバーサル
朴实	pǔ shí	シンプル
朴素	pǔ sù	シンプル
瀑布	pù bù	滝
凄凉	qī liáng	荒涼とした
期望	qī wàng	期待する
期限	qī xiàn	用語
欺负	qī fu	いじめっ子
欺骗	qī piàn	欺く
奇妙	qí miào	素晴らしい
旗袍	qí páo	チョンサム
旗帜	qí zhì	バナー
歧视	qí shì	差別
齐全	qí quán	コンプリート
齐心协力	qí xīn xié lì	共に働く
乞丐	qǐ gài	乞食
企图	qǐ tú	試みる
启程	qǐ chéng	出発する
启蒙	qǐ méng	啓発
启事	qǐ shì	通知
启示	qǐ shì	啓発
岂有此理	qǐ yǒu cǐ lǐ	不合理
起草	qǐ cǎo	製図
起初	qǐ chū	最初は
起伏	qǐ fú	浮き沈み
起哄	qǐ hòng	ブーイング
起码	qǐ mǎ	少なくとも
起源	qǐ yuán	原点
器材	qì cái	装置
器官	qì guān	器官
气概	qì gài	精神
气功	qì gōng	qigong
气魄	qì pò	大胆な
气色	qì sè	顔色
气势	qì shì	勢い
气味	qì wèi	におい
气象	qì xiàng	気象学
气压	qì yā	空気圧
气质	qì zhí	気質
迄今为止	qì jīn wéi zhǐ	これまでのところ
掐	qiā	ピンチ
恰当	qià dàng	適切な
恰到好处	qià dào hǎo chù	ちょうどいい
恰巧	qià qiǎo	偶然にも
洽谈	qià tán	交渉する
千方百计	qiān fāng bǎi jì	可能な限りのことをする
牵	qiān	鉛
牵扯	qiān chě	関与する
牵制	qiān zhì	含む
签署	qiān shǔ	符号
谦逊	qiān xùn	謙虚な
迁就	qiān jiù	収容する
迁徙	qiān xǐ	移行
前景	qián jǐng	見込み
前提	qián tí	前提
潜力	qián lì	潜在的な
潜水	qián shuǐ	ダイビング
潜移默化	qián yí mò huà	いつの間にか
谴责	qiǎn zé	非難する
抢劫	qiāng jié	強盗
强制	qiáng zhì	必須
强迫	qiǎng pò	力
抢救	qiǎng jiù	救援
桥梁	qiáo liáng	ブリッジ
窍门	qiào mén	騙す
翘	qiào	アリス
切实	qiè shí	実用的
锲而不舍	qiè ér bù shě	忍耐力
亲密	qīn mì	閉じる
亲热	qīn rè	愛情深い
侵犯	qīn fàn	違反する
侵略	qīn lvè	侵略
钦佩	qīn pèi	感嘆
勤俭	qín jiǎn	勤勉な
勤劳	qín láo	勤勉
倾听	qīng tīng	聴く
倾向	qīng xiàng	傾向
倾斜	qīng xié	傾ける
清澈	qīng chè	晴れ
清晨	qīng chén	朝早く
清除	qīng chú	晴れ
清洁	qīng jié	掃除
清理	qīng lǐ	掃除
清晰	qīng xī	晴れ
清醒	qīng xǐng	キンキンに目が覚めた
清真	qīng zhēn	イスラム教徒
情报	qíng bào	インテリジェンス
情节	qíng jié	プロット
情理	qíng lǐ	センス
情形	qíng xíng	状況
晴朗	qíng lǎng	晴れ
请柬	qǐng jiǎn	招待
请教	qǐng jiào	相談する
请示	qǐng shì	指示を求める
请帖	qǐng tiě	招待
丘陵	qiū líng	丘
区分	qū fēn	区別する
区域	qū yù	範囲
屈服	qū fú	産出
曲折	qū zhé	曲がりくねった
驱逐	qū zhú	追放
渠道	qú dào	チャネル
取缔	qǔ dì	禁止
曲子	qǔ zi	歌
趣味	qù wèi	味
圈套	quān tào	トラップ
全局	quán jú	グローバル
全力以赴	quán lì yǐ fù	全部出て
拳头	quán tou	拳
权衡	quán héng	トレード・オフ
权威	quán wēi	権限
犬	quǎn	犬
缺口	quē kǒu	ギャップ
缺席	quē xí	不在
缺陷	quē xiàn	欠陥
瘸	qué	ラメ
确保	què bǎo	確認してください
确立	què lì	確立する
确切	què qiè	正確
确信	què xìn	納得
群众	qún zhòng	大衆
染	rǎn	染料
嚷	rǎng	叫ぶ
让步	ràng bù	租界
饶恕	ráo shù	許しなさい
扰乱	rǎo luàn	乱す
惹祸	rě huò	法廷災害
热泪盈眶	rè lèi yíng kuàng	目の涙
热门	rè mén	人気
人道	rén dào	人道的
人格	rén gé	人
人工	rén gōng	人工的な
人家	rén jia	人
人间	rén jiān	世界
人士	rén shì	人
人为	rén wéi	人工的な
人性	rén xìng	人間の本性
人质	rén zhì	人質
仁慈	rén cí	親切
忍耐	rěn nài	忍耐
忍受	rěn shòu	耐える
任命	rèn mìng	予定
任性	rèn xìng	気まぐれ
任意	rèn yì	任意
任重道远	rèn zhòng dào yuǎn	長い道のり
认定	rèn dìng	認識する
认可	rèn kě	認識された
仍旧	réng jiù	それでも
日新月异	rì xīn yuè yì	日を追うごとに変わる
日益	rì yì	ますます
容貌	róng mào	外観
容纳	róng nà	収容する
容器	róng qì	コンテナ
容忍	róng rěn	許容する
溶解	róng jiě	溶解する
荣幸	róng xìng	喜んで
荣誉	róng yù	名誉
融化	róng huà	溶ける
融洽	róng qià	信頼関係
揉	róu	こする
柔和	róu hé	柔らかい
儒家	rú jiā	儒教
弱点	ruò diǎn	弱点
若干	ruò gān	いくつか
撒谎	sā huǎng	横たわる
散文	sǎn wén	散文
散布	sàn bù	拡大
散发	sàn fā	分配します
丧失	sàng shī	失う
骚扰	sāo rǎo	ハラス
嫂子	sǎo zi	義理の姉妹
刹车	shā chē	ブレーキ
啥	shá	何
筛选	shāi xuǎn	フィルタ
山脉	shān mài	山
闪烁	shǎn shuò	点滅
擅长	shàn cháng	が上手
擅自	shàn zì	無許可
伤脑筋	shāng nǎo jīn	面倒
商标	shāng biāo	商標
上级	shàng jí	優れました
上进	shàng jìn	動機付ける
上任	shàng rèn	就任します
上瘾	shàng yǐn	病みつき
上游	shàng yóu	上流の
尚且	shàng qiě	それでも
捎	shāo	連れていく
梢	shāo	ヒント
哨	shào	役職
奢侈	shē chǐ	贅沢
舌头	shé tou	舌
摄氏度	shè shì dù	摂氏
涉及	shè jí	関与
社区	shè qū	コミュニティ
设立	shè lì	セットアップ
设想	shè xiǎng	想像してみてください
设置	shè zhì	セットアップ
呻吟	shēn yín	うめき声
深奥	shēn ào	深遠
深沉	shēn chén	深い
深情厚谊	shēn qíng hòu yì	深い友情
申报	shēn bào	宣言する
绅士	shēn shì	紳士
神经	shén jīng	神経
神奇	shén qí	魔法の
神气	shén qì	空気
神圣	shén shèng	神聖
神态	shén tài	物腰
神仙	shén xiān	不滅
审查	shěn chá	レビュー
审理	shěn lǐ	トライアル
审美	shěn měi	美的
审判	shěn pàn	トライアル
慎重	shèn zhòng	注意してください
渗透	shèn tòu	浸透
声明	shēng míng	ステートメント
声势	shēng shì	勢い
声誉	shēng yù	評判
牲畜	shēng chù	家畜
生存	shēng cún	生き残ります
生机	shēng jī	活力
生理	shēng lǐ	生理学的
生疏	shēng shū	さびた
生态	shēng tài	エコロジー
生物	shēng wù	生物学的
生效	shēng xiào	有効にする
生肖	shēng xiào	ゾディアック
生锈	shēng xiù	さび
生育	shēng yù	受胎能力
省会	shěng huì	州都
盛产	shèng chǎn	リッチ
盛开	shèng kāi	咲く
盛情	shèng qíng	おもてなし
盛行	shèng xíng	勝つ
胜负	shèng fù	勝つか負けるか
失事	shī shì	難破
失误	shī wù	間違い
失踪	shī zōng	行方不明
尸体	shī tǐ	死体
师范	shī fàn	先生
施加	shī jiā	課す
施展	shī zhǎn	表示
十足	shí zú	フル
实惠	shí huì	手ごろな価格
实力	shí lì	力
实施	shí shī	実装する
实事求是	shí shì qiú shì	事実から真実を探る
实行	shí xíng	実装する
实质	shí zhì	物質
拾	shí	選び出す
时常	shí cháng	しばしば
时而	shí ér	時々
时光	shí guāng	時間
时机	shí jī	機会
时事	shí shì	時事問題
石油	shí yóu	油
识别	shí bié	識別する
使命	shǐ mìng	ミッション
世代	shì dài	世代
事故	shì gù	事故
事迹	shì jì	行為
事件	shì jiàn	イベント
事态	shì tài	状況
事务	shì wù	事務
事项	shì xiàng	案件
事业	shì yè	原因
势必	shì bì	にバインドされています
势力	shì li	パワー
是非	shì fēi	正しいか間違っているか
示范	shì fàn	デモンストレーション
示威	shì wēi	デモンストレーション
示意	shì yì	信号
视力	shì lì	ビジョン
视频	shì pín	ビデオ
视线	shì xiàn	視力
视野	shì yě	ビジョン
试图	shì tú	試みる
试验	shì yàn	テスト
适宜	shì yí	適切
逝世	shì shì	亡くなる
释放	shì fàng	解放された
收藏	shōu cáng	お気に入り
收缩	shōu suō	シュリンク
收益	shōu yì	所得
收音机	shōu yīn jī	無線
守护	shǒu hù	ガード
手法	shǒu fǎ	技術
手势	shǒu shì	ジェスチャー
手艺	shǒu yì	クラフト
首饰	shǒu shì	宝石
首要	shǒu yào	プライマリ
受罪	shòu zuì	苦しむ
授予	shòu yǔ	付与
书法	shū fǎ	書道
书记	shū ji	秘書
书籍	shū jí	本
书面	shū miàn	書かれた
疏忽	shū hu	怠慢
疏远	shū yuǎn	alienate
舒畅	shū chàng	快適
数额	shù é	量
束	shù	バンドル
束缚	shù fù	ボンデージ
树立	shù lì	セットアップ
竖	shù	垂直
耍	shuǎ	演奏する
衰老	shuāi lǎo	老化
衰退	shuāi tuì	低下
率领	shuài lǐng	鉛
涮火锅	shuàn huǒ guō	しゃぶしゃぶ
双胞胎	shuāng bāo tāi	ツイン
爽快	shuǎng kuài	すぐに
水利	shuǐ lì	節水
水龙头	shuǐ lóng tóu	蛇口
水泥	shuǐ ní	セメント
瞬间	shùn jiān	瞬間
司法	sī fǎ	司法
司令	sī lìng	司令官
思念	sī niàn	お嬢
思索	sī suǒ	考え
思维	sī wéi	考え
斯文	sī wen	優しい
私自	sī zì	個人的に
死亡	sǐ wáng	死
四肢	sì zhī	肢
寺庙	sì miào	寺院
肆无忌惮	sì wú jì dàn	不謹慎
饲养	sì yǎng	飼育
耸	sǒng	そびえ立つ
艘	sōu	輸送する
苏醒	sū xǐng	ウェイク
俗话	sú huà	スラング
塑造	sù zào	形状
素食	sù shí	ベジタリアンフード
素质	sù zhì	品質
诉讼	sù sòng	訴訟
算数	suàn shù	カウント
随即	suí jí	すぐに
随意	suí yì	ランダム
岁月	suì yuè	年
隧道	suì dào	トンネル
损坏	sǔn huài	ダメージ
索取	suǒ qǔ	リクエスト
索性	suǒ xìng	単に
塌	tā	崩壊
踏实	tā shi	安定
塔	tǎ	タワー
台风	tái fēng	台風
太空	tài kōng	スペース
泰斗	tài dǒu	ディーン
摊	tān	ストール
瘫痪	tān huàn	麻痺
贪婪	tān lán	貪欲
贪污	tān wū	腐敗
弹性	tán xìng	弾性
坦白	tǎn bái	率直
叹气	tàn qì	はぁ
探测	tàn cè	検出
探索	tàn suǒ	見る
探讨	tàn tǎo	見る
探望	tàn wàng	訪問
倘若	tǎng ruò	もし
掏	tāo	掘る
滔滔不绝	tāo tāo bù jué	延々と話す
淘汰	táo tài	排除
陶瓷	táo cí	セラミック
陶醉	táo zuì	楽しむ
讨好	tǎo hǎo	お願いします
特长	tè cháng	専門
特定	tè dìng	明確な
特意	tè yì	特に
提拔	tí bá	昇格
提炼	tí liàn	精製
提示	tí shì	促す
提议	tí yì	提案
题材	tí cái	テーマ
体裁	tǐ cái	ジャンル
体积	tǐ jī	ボリューム
体谅	tǐ liàng	思いやりのある
体面	tǐ miàn	まともな
体系	tǐ xì	システム
天才	tiān cái	天才
天赋	tiān fù	才能
天伦之乐	tiān lún zhī lè	家族での楽しみ
天然气	tiān rán qì	天然ガス
天生	tiān shēng	生まれ
天堂	tiān táng	天国
天文	tiān wén	天文学
田径	tián jìng	トラックとフィールド
田野	tián yě	フィールド
舔	tiǎn	なめる
挑剔	tiāo ti	選り好み
条款	tiáo kuǎn	条項
条理	tiáo lǐ	組織された
条约	tiáo yuē	条約
调和	tiáo hé	調整する
调剂	tiáo jì	調整する
调节	tiáo jié	調整する
调解	tiáo jiě	調停
调料	tiáo liào	調味料
挑拨	tiǎo bō	プレーオフ
挑衅	tiǎo xìn	挑発的
跳跃	tiào yuè	ジャンプ
亭子	tíng zi	パビリオン
停泊	tíng bó	駐車
停顿	tíng dùn	一時停止
停滞	tíng zhì	停滞
挺拔	tǐng bá	背が高くまっすぐ
通货膨胀	tōng huò péng zhàng	インフレーション
通缉	tōng jī	欲しかった
通俗	tōng sú	人気
通讯	tōng xùn	コミュニケーション
通用	tōng yòng	ユニバーサル
同胞	tóng bāo	兄弟
同志	tóng zhì	ゲイ
童话	tóng huà	おとぎ話
铜	tóng	銅
统筹兼顾	tǒng chóu jiān gù	全体的な計画
统计	tǒng jì	統計学
统统	tǒng tǒng	すべて
统治	tǒng zhì	ルール
投机	tóu jī	投機
投票	tóu piào	投票
投诉	tóu sù	苦情文句
投降	tóu xiáng	降伏
投掷	tóu zhì	スロー
透露	tòu lù	開示する、明らかにする
秃	tū	はげ
突破	tū pò	画期的な
图案	tú àn	パターン
徒弟	tú dì	見習い
涂抹	tú mǒ	塗抹標本
途径	tú jìng	仕方
土壤	tǔ rǎng	土
团结	tuán jié	団結
团体	tuán tǐ	グループ
团圆	tuán yuán	再会
推测	tuī cè	推測する
推翻	tuī fān	打倒
推理	tuī lǐ	推論
推论	tuī lùn	推論
推销	tuī xiāo	売る
吞吞吐吐	tūn tūn tǔ tǔ	ためらう
托运	tuō yùn	委託
拖延	tuō yán	怠慢
脱离	tuō lí	離脱する
妥当	tuǒ dang	適切な
妥善	tuǒ shàn	適切
妥协	tuǒ xié	妥協
椭圆	tuǒ yuán	楕円形
唾弃	tuò qì	投げ捨てます
哇	wa	ワオ
挖掘	wā jué	掘る
娃娃	wá wa	人形
瓦解	wǎ jiě	崩壊
歪曲	wāi qū	歪む
外表	wài biǎo	外観
外行	wài háng	素人
外界	wài jiè	外の世界
外向	wài xiàng	発信
丸	wán	ピル
完备	wán bèi	コンプリート
完毕	wán bì	コンプリート
玩弄	wán nòng	演奏する
玩意儿	wán yì r	事
顽固	wán gù	頑固
顽强	wán qiáng	粘り強い
惋惜	wǎn xī	後悔
挽回	wǎn huí	引き換え
挽救	wǎn jiù	セーブ
万分	wàn fēn	非常に
往常	wǎng cháng	いつものように
往事	wǎng shì	過去
妄想	wàng xiǎng	妄想
危机	wēi jī	危機
威风	wēi fēng	威信
威力	wēi lì	パワー
威望	wēi wàng	威信
威信	wēi xìn	威信
微不足道	wēi bù zú dào	無視できる
微观	wēi guān	マイクロ
为难	wéi nán	恥ずかしい
为期	wéi qī	期間
唯独	wéi dú	一人で
维持	wéi chí	維持する
维护	wéi hù	維持する
维生素	wéi shēng sù	ビタミン
违背	wéi bèi	反対する
伪造	wěi zào	偽造
委托	wěi tuō	手数料
委员	wěi yuán	委員
卫星	wèi xīng	衛星
喂	wèi	こんにちは（動詞）
慰问	wèi wèn	お悔やみ
未免	wèi miǎn	必然
畏惧	wèi jù	恐れ
蔚蓝	wèi lán	azure
温带	wēn dài	温帯
温和	wēn hé	軽度
文凭	wén píng	ディプロマ
文物	wén wù	文化的遺物
文献	wén xiàn	文献
文雅	wén yǎ	エレガント
文艺	wén yì	アート
问世	wèn shì	出てくる
窝	wō	ネスト
乌黑	wū hēi	漆黒
污蔑	wū miè	中傷
诬陷	wū xiàn	フレーム
无比	wú bǐ	非常に
无偿	wú cháng	自由
无耻	wú chǐ	恥知らず
无动于衷	wú dòng yú zhōng	無関心
无非	wú fēi	何も
无辜	wú gū	無実
无精打采	wú jīng dǎ cǎi	リストレス
无赖	wú lài	ローグ
无理取闹	wú lǐ qǔ nào	不合理
无能为力	wú néng wéi lì	無力
无穷无尽	wú qióng wú jìn	エンドレス
无微不至	wú wēi bù zhì	細心の注意
无忧无虑	wú yōu wú lv4	のんき
无知	wú zhī	無知
侮辱	wǔ rǔ	侮辱
武器	wǔ qì	腕
武侠	wǔ xiá	武道
武装	wǔ zhuāng	武装
舞蹈	wǔ dǎo	ダンス
务必	wù bì	必ず
物美价廉	wù měi jià lián	良質で安い
物业	wù yè	プロパティ
物资	wù zī	用品
误差	wù chā	エラー
误解	wù jiě	誤解
夕阳	xī yáng	日没
昔日	xī rì	昔な日々
溪	xī	クリーク
熄灭	xī miè	外出する
牺牲	xī shēng	犠牲
膝盖	xī gài	膝
习俗	xí sú	カスタム
媳妇	xí fu	義理の娘
袭击	xí jī	アサルト
喜闻乐见	xǐ wén lè jiàn	聞くのが大好き
喜悦	xǐ yuè	喜び
系列	xì liè	シリーズ
细菌	xì jūn	バクテリア
细胞	xì bāo	細胞
细致	xì zhì	細心の注意
峡谷	xiá gǔ	キャニオン
狭隘	xiá ài	狭い
狭窄	xiá zhǎi	狭い
霞	xiá	xia
下属	xià shǔ	下位
先进	xiān jìn	高度な
先前	xiān qián	以前
掀起	xiān qǐ	出発する
纤维	xiān wéi	ファイバ
鲜明	xiān míng	明るい
嫌	xián	嫌い
嫌疑	xián yí	容疑者
弦	xián	ストリング
衔接	xián jiē	接続
贤惠	xián huì	好意的
闲话	xián huà	ゴシップ
显著	xiǎn zhù	重要
宪法	xiàn fǎ	憲法
现场	xiàn chǎng	現場で
现成	xiàn chéng	既製
现状	xiàn zhuàng	現状
线索	xiàn suǒ	手がかり
陷害	xiàn hài	額装
陷阱	xiàn jǐng	トラップ
陷入	xiàn rù	に落ちる
馅儿	xiàn r	詰め物
乡镇	xiāng zhèn	タウンシップ
相差	xiāng chà	差
相等	xiāng děng	等しい
相辅相成	xiāng fǔ xiāng chéng	それぞれを補完しあう
相应	xiāng yìng	対応する
镶嵌	xiāng qiàn	モザイク
响亮	xiǎng liàng	大声で
响应	xiǎng yìng	応答
想方设法	xiǎng fāng shè fǎ	方法を見つける
向导	xiàng dǎo	ガイド
向来	xiàng lái	常に
向往	xiàng wǎng	憧れ
巷	xiàng	lane
相声	xiàng sheng	クロストーク
消除	xiāo chú	排除する
消毒	xiāo dú	消毒する
消防	xiāo fáng	消防
消耗	xiāo hào	消費する
消灭	xiāo miè	一掃する
潇洒	xiāo sǎ	シック
销毁	xiāo huǐ	破壊
小心翼翼	xiǎo xīn yì yì	慎重に
效益	xiào yì	メリット
肖像	xiào xiàng	肖像画
协会	xié huì	協会
协商	xié shāng	交渉する
协调	xié tiáo	調整
协议	xié yì	プロトコル
协助	xié zhù	支援する
携带	xié dài	運ぶ
屑	xiè	クラム
泄露	xiè lù	道を譲る
泄气	xiè qì	落胆
谢绝	xiè jué	低下
心得	xīn dé	経験
心甘情愿	xīn gān qíng yuàn	喜んで
心灵	xīn líng	魂
心态	xīn tài	メンタリティ
心疼	xīn téng	苦しめられた
心血	xīn xuè	ハードワーク
心眼儿	xīn yǎn r	マインドフル
新陈代谢	xīn chén dài xiè	代謝
新郎	xīn láng	花婿
新娘	xīn niáng	花嫁
新颖	xīn yǐng	小説
欣慰	xīn wèi	満足
欣欣向荣	xīn xīn xiàng róng	繁栄
薪水	xīn shuǐ	給料
辛勤	xīn qín	ハードワーク
信赖	xìn lài	信頼
信念	xìn niàn	信念
信仰	xìn yǎng	信仰
信誉	xìn yù	評判
兴高采烈	xīng gāo cǎi liè	大喜び
兴隆	xīng lóng	繁栄
兴旺	xīng wàng	繁栄
腥	xīng	魚のような
刑事	xíng shì	犯罪者
形态	xíng tài	形
行政	xíng zhèng	管理
兴致勃勃	xìng zhì bó bó	興奮した
性感	xìng gǎn	セクシー
性命	xìng mìng	生活
性能	xìng néng	パフォーマンス
凶恶	xiōng è	悪質
凶手	xiōng shǒu	殺人者
汹涌	xiōng yǒng	乱流
胸怀	xiōng huái	マインド
胸膛	xiōng táng	胸
雄厚	xióng hòu	強い
雄伟	xióng wěi	雄大な
修复	xiū fù	修復
修建	xiū jiàn	ビルド
修养	xiū yǎng	トレーニング
羞耻	xiū chǐ	恥
嗅觉	xiù jué	におい
绣	xiù	刺繍
虚假	xū jiǎ	false
虚荣	xū róng	虚栄心
虚伪	xū wěi	偽善的
需求	xū qiú	要求する
须知	xū zhī	通知
许可	xǔ kě	ライセンス
序言	xù yán	序文
畜牧	xù mù	畜産
酗酒	xù jiǔ	アルコール依存症
喧哗	xuān huá	uproar
宣誓	xuān shì	誓いを立てる
宣扬	xuān yáng	説教
悬挂	xuán guà	サスペンション
悬念	xuán niàn	サスペンス
悬殊	xuán shū	格差
悬崖峭壁	xuán yá qiào bì	崖
旋律	xuán lv4	メロディー
旋转	xuán zhuǎn	スピン
选拔	xuǎn bá	選択
选举	xuǎn jǔ	選挙
选手	xuǎn shǒu	プレーヤー
炫耀	xuàn yào	見せびらかす
削	xuē	切る
削弱	xuē ruò	弱める
学说	xué shuō	理論
学位	xué wèi	理学士
雪上加霜	xuě shàng jiā shuāng	さらに悪い
血压	xuè yā	血圧
熏陶	xūn táo	エディファイ
寻觅	xún mì	検索
巡逻	xún luó	パトロール
循环	xún huán	サイクル
循序渐进	xún xù jiàn jìn	ステップバイステップ
压迫	yā pò	抑圧
压岁钱	yā suì qián	新年のお金
压缩	yā suō	圧縮
压抑	yā yì	落ち込んでいる
压榨	yā zhà	押す
压制	yā zhì	抑制
鸦雀无声	yā què wú shēng	サイレント
亚军	yà jūn	準優勝
淹没	yān mò	水没
烟花爆竹	yān huā bào zhú	ファイヤークラッカー
严峻	yán jùn	重度
严寒	yán hán	ひどい寒さ
严禁	yán jìn	固く禁止
严厉	yán lì	重度
严密	yán mì	タイト
岩石	yán shí	岩
延期	yán qī	拡張
延伸	yán shēn	拡張する
延续	yán xù	継続する
沿海	yán hǎi	沿岸
炎热	yán rè	ホット
言论	yán lùn	スピーチ
掩盖	yǎn gài	カバー
掩护	yǎn hù	カバー
掩饰	yǎn shì	隠ぺいする
演变	yǎn biàn	進化
演习	yǎn xí	運動
演绎	yǎn yì	控除
演奏	yǎn zòu	遊ぶ
眼光	yǎn guāng	ビジョン
眼色	yǎn sè	ウィンク
眼神	yǎn shén	見て
厌恶	yàn wù	嫌悪
验收	yàn shōu	受け入れ
验证	yàn zhèng	検証
氧气	yǎng qì	酸素
样品	yàng pǐn	サンプル
摇摆	yáo bǎi	スイング
摇滚	yáo gǔn	岩
谣言	yáo yán	噂
遥控	yáo kòng	リモコン
遥远	yáo yuǎn	遠い
耀眼	yào yǎn	眩しい
要点	yào diǎn	ポイント
要命	yào mìng	ひどい
要素	yào sù	素子
野蛮	yě mán	残忍な
野心	yě xīn	野心
液体	yè tǐ	液体
一流	yī liú	ファーストクラス
一如既往	yī rú jì wǎng	いつものように
依旧	yī jiù	まだ
依据	yī jù	に従い
依靠	yī kào	頼る
依赖	yī lài	頼る
依托	yī tuō	に頼る
衣裳	yī shang	服
一度	yí dù	一度
一贯	yí guàn	一貫性がある
一目了然	yí mù liǎo rán	一目で
一向	yí xiàng	常に
仪器	yí qì	楽器
仪式	yí shì	式
疑惑	yí huò	疑問に思う
遗产	yí chǎn	遺産
遗传	yí chuán	遺伝的
遗留	yí liú	レガシー
遗失	yí shī	失われた
以便	yǐ biàn	そのため
以免	yǐ miǎn	しないように
以往	yǐ wǎng	過去には
以至	yǐ zhì	でも
以致	yǐ zhì	そのため
一帆风顺	yì fān fēng shùn	順風満帆
一举两得	yì jǔ liǎng dé	一石二鳥
一丝不苟	yì sī bù gǒu	細心の注意
亦	yì	また
异常	yì cháng	異常な
意料	yì liào	期待される
意识	yì shí	意識
意图	yì tú	意図
意味着	yì wèi zhe	平均
意向	yì xiàng	意図
意志	yì zhì	意志
毅力	yì lì	忍耐力
毅然	yì rán	断固として
翼	yì	羽
阴谋	yīn móu	陰謀
音响	yīn xiǎng	音
引导	yǐn dǎo	ガイド
引擎	yǐn qíng	エンジン
引用	yǐn yòng	見積もり
隐蔽	yǐn bì	隠された
隐患	yǐn huàn	隠れた危険
隐瞒	yǐn mán	隠す
隐私	yǐn sī	プライバシー
隐约	yǐn yuē	かすかな
饮食	yǐn shí	ダイエット
婴儿	yīng ér	赤ちゃん
英明	yīng míng	賢い
英勇	yīng yǒng	ヒロイック
盈利	yíng lì	利益
迎面	yíng miàn	正面から
应酬	yìng chou	交流する
应邀	yìng yāo	招待される
庸俗	yōng sú	下品
拥护	yōng hù	サポート
拥有	yōng yǒu	持ってる
勇于	yǒng yú	ブレイブ
永恒	yǒng héng	永遠の
涌现	yǒng xiàn	出現
踊跃	yǒng yuè	積極的に
用户	yòng hù	ユーザー
优胜劣汰	yōu shèng liè tài	適者生存
优先	yōu xiān	優先度
优异	yōu yì	優秀な
优越	yōu yuè	優れました
忧郁	yōu yù	憂鬱
油腻	yóu nì	脂っこい
油漆	yóu qī	ペイント
犹如	yóu rú	かのように
有条不紊	yǒu tiáo bù wěn	整然とした
幼稚	yòu zhì	ナイーブ
诱惑	yòu huò	ウィズイン・テンプテーション
愚蠢	yú chǔn	ばかげている
愚昧	yú mèi	無知
渔民	yú mín	漁師
舆论	yú lùn	世論
与日俱增	yǔ rì jù zēng	日々増加
宇宙	yǔ zhòu	宇宙
羽绒服	yǔ róng fú	ダウンジャケット
寓言	yù yán	寓話
愈	yù	癒す
欲望	yù wàng	欲望
熨	yù	アイロンがけ
玉	yù	翡翠
预料	yù liào	期待される
预期	yù qī	期待される
预算	yù suàn	予算
预先	yù xiān	前進
预言	yù yán	預言
预兆	yù zhào	前兆
冤枉	yuān wang	苦しめられた
元首	yuán shǒu	国家元首
元素	yuán sù	素子
元宵节	yuán xiāo jié	提灯祭り
原告	yuán gào	原告
原理	yuán lǐ	原理
原始	yuán shǐ	元の
原先	yuán xiān	元の
园林	yuán lín	庭園
圆满	yuán mǎn	コンプリート
源泉	yuán quán	ソース
缘故	yuán gù	理由
约束	yuē shù	制約
乐谱	yuè pǔ	シートミュージック
岳母	yuè mǔ	義理の母
孕育	yùn yù	品種
蕴藏	yùn cáng	含む
运算	yùn suàn	計算
运行	yùn xíng	実行
酝酿	yùn niàng	醸造
杂技	zá jì	曲芸
杂交	zá jiāo	ハイブリダイゼーション
砸	zá	スマッシュ
咋	zǎ	どうやって
栽培	zāi péi	栽培
灾难	zāi nàn	災害
宰	zǎi	虐殺
再接再厉	zài jiē zài lì	粘り強く努力する
在意	zài yì	ケア
攒	zǎn	セーブ
暂且	zàn qiě	当面
赞叹	zàn tàn	賞賛する
赞助	zàn zhù	スポンサー
糟蹋	zāo tà	甘やかす
遭受	zāo shòu	苦しむ
遭殃	zāo yāng	苦しむ
遭遇	zāo yù	出会い
噪音	zào yīn	ノイズ
造型	zào xíng	モデリング
责怪	zé guài	非難
贼	zéi	泥棒
增添	zēng tiān	追加
赠送	zèng sòng	与える
扎	zhā	ネクタイ
扎实	zhā shi	固体
渣	zhā	スラグ
眨	zhǎ	点滅
诈骗	zhà piàn	詐欺
摘要	zhāi yào	概要
债券	zhài quàn	つなぐ
沾光	zhān guāng	浸漬
瞻仰	zhān yǎng	に敬意を表する
展示	zhǎn shì	見せびらかす
展望	zhǎn wàng	見通し
展现	zhǎn xiàn	見せびらかす
崭新	zhǎn xīn	真新しい
斩钉截铁	zhǎn dīng jié tiě	断固として
占据	zhàn jù	占める
占领	zhàn lǐng	占領
战斗	zhàn dòu	戦い
战略	zhàn lvè	戦略
战术	zhàn shù	戦術
战役	zhàn yì	戦い
章程	zhāng chéng	チャーター
帐篷	zhàng peng	テント
障碍	zhàng ài	障害
招标	zhāo biāo	入札
招收	zhāo shōu	リクルート
朝气蓬勃	zhāo qì péng bó	活発
着迷	zháo mí	魅了された
沼泽	zhǎo zé	沼地
照样	zhào yàng	それでも
照耀	zhào yào	輝く
折腾	zhē teng	投げ捨てる
遮挡	zhē dǎng	オクルード
折	zhé	折りたたむ
折磨	zhé mó	拷問
侦探	zhēn tàn	探偵
斟酌	zhēn zhuó	検討する
珍贵	zhēn guì	貴重な
珍稀	zhēn xī	レア
珍珠	zhēn zhū	パール
真理	zhēn lǐ	真実
真相	zhēn xiàng	真実
真挚	zhēn zhì	誠実
枕头	zhěn tou	枕
振奋	zhèn fèn	隆起
振兴	zhèn xīng	活性化
镇定	zhèn dìng	落ち着いて
镇静	zhèn jìng	落ち着いて
阵地	zhèn dì	ポジション
阵容	zhèn róng	ラインナップ
震撼	zhèn hàn	ショック
震惊	zhèn jīng	ショック
争端	zhēng duān	紛争
争夺	zhēng duó	競合
争气	zhēng qì	勝つ
争先恐后	zhēng xiān kǒng hòu	スクランブリング
争议	zhēng yì	紛争
征服	zhēng fú	征服する
征收	zhēng shōu	コレクション
挣扎	zhēng zhá	闘争
正月	zhēng yuè	最初の月
蒸发	zhēng fā	蒸発
整顿	zhěng dùn	修正する
政策	zhèng cè	ポリシー
政权	zhèng quán	政権
正当	zhèng dāng	正当化
正负	zhèng fù	ポジティブとネガティブ
正规	zhèng guī	レギュラー
正经	zhèng jing	深刻
正气	zhèng qì	正義
正义	zhèng yì	正義
正宗	zhèng zōng	本物
症状	zhèng zhuàng	症状
证实	zhèng shí	確認
证书	zhèng shū	証明書
郑重	zhèng zhòng	粛々と
之际	zhī jì	その際
支撑	zhī chēng	サポート
支出	zhī chū	支出
支流	zhī liú	支流
支配	zhī pèi	支配する
支援	zhī yuán	サポート
支柱	zhī zhù	柱
枝	zhī	ブランチ
知觉	zhī jué	知覚
知足常乐	zhī zú cháng lè	満足
脂肪	zhī fáng	太い
侄子	zhí zi	甥
值班	zhí bān	勤務中
执行	zhí xíng	実施した
执着	zhí zhuó	永続性
殖民地	zhí mín dì	コロニー
直播	zhí bō	生放送
直径	zhí jìng	直径
职能	zhí néng	関数
职位	zhí wèi	ポジション
职务	zhí wù	ポジション
指标	zhǐ biāo	インデックス
指定	zhǐ dìng	指定する
指甲	zhǐ jia	釘
指令	zhǐ lìng	命令
指南针	zhǐ nán zhēn	方位磁針
指示	zhǐ shì	指示
指望	zhǐ wàng	頼りに
指责	zhǐ zé	告発
制裁	zhì cái	制裁
制服	zhì fú	ユニフォーム
制约	zhì yuē	拘束
制止	zhì zhǐ	やめる
志气	zhì qì	野心
智力	zhì lì	インテリジェンス
智能	zhì néng	インテリジェント
智商	zhì shāng	iq
治安	zhì ān	法と秩序
治理	zhì lǐ	ガバナンス
滞留	zhì liú	滞在
致辞	zhì cí	住所
致力	zhì lì	に専心して
致使	zhì shǐ	原因
中断	zhōng duàn	割り込み
中立	zhōng lì	中性
中央	zhōng yāng	中央
忠诚	zhōng chéng	ロイヤリティ
忠实	zhōng shí	忠実な
终点	zhōng diǎn	終わり
终究	zhōng jiū	結局
终身	zhōng shēn	生涯
终止	zhōng zhǐ	終了
衷心	zhōng xīn	心から
种子	zhǒng zi	シード
种族	zhǒng zú	人種
肿瘤	zhǒng liú	腫瘍
众所周知	zhòng suǒ zhōu zhī	よく知られている
种植	zhòng zhí	植付
重心	zhòng xīn	重心
周边	zhōu biān	周囲
周密	zhōu mì	注意してください
周年	zhōu nián	記念日
周期	zhōu qī	サイクル
周折	zhōu zhé	振り向く
周转	zhōu zhuǎn	売上高
州	zhōu	状態
粥	zhōu	おかゆ
舟	zhōu	ボート
昼夜	zhòu yè	昼と夜
皱纹	zhòu wén	しわ
株	zhū	ひずみ
诸位	zhū wèi	全員
逐年	zhú nián	年々
主办	zhǔ bàn	ホスト
主导	zhǔ dǎo	リーディング
主管	zhǔ guǎn	スーパーバイザー
主流	zhǔ liú	主流
主权	zhǔ quán	主権
主义	zhǔ yì	教義
嘱咐	zhǔ fù	勧める
拄	zhǔ	絞る
住宅	zhù zhái	居住の
助理	zhù lǐ	課長補佐
助手	zhù shǒu	アシスタント
注射	zhù shè	注入
注视	zhù shì	見る
注释	zhù shì	コメント
注重	zhù zhòng	注意を払う
著作	zhù zuò	本
铸造	zhù zào	鋳造
驻扎	zhù zhā	駐留
拽	zhuài	引っ張る
专长	zhuān cháng	専門知識
专程	zhuān chéng	特別旅行
专利	zhuān lì	特許
专题	zhuān tí	トピック
砖	zhuān	レンガ
转达	zhuǎn dá	伝える
转让	zhuǎn ràng	転送
转移	zhuǎn yí	転送
转折	zhuǎn zhé	ターニングポイント
传记	zhuàn jì	バイオグラフィー
庄稼	zhuāng jià	作物
庄严	zhuāng yán	厳粛
庄重	zhuāng zhòng	厳粛
装备	zhuāng bèi	装置
装卸	zhuāng xiè	上げ下ろし
壮观	zhuàng guān	壮観
壮丽	zhuàng lì	壮大
壮烈	zhuàng liè	ヒロイック
幢	zhuàng	建物
追悼	zhuī dào	記念
追究	zhuī jiū	調査する
坠	zhuì	秋
准则	zhǔn zé	ガイドライン
卓越	zhuó yuè	優秀
琢磨	zhuó mó	熟考
着手	zhuó shǒu	約設定
着想	zhuó xiǎng	のために
着重	zhuó zhòng	焦点を合わせる
姿态	zī tài	姿勢
滋润	zī rùn	保湿
滋味	zī wèi	味
资本	zī běn	資本
资产	zī chǎn	資産
资深	zī shēn	上級
资助	zī zhù	資金調達
子弹	zǐ dàn	弾丸
自卑	zì bēi	劣等感
自发	zì fā	自発
自力更生	zì lì gēng shēng	自立
自满	zì mǎn	自己満足
自主	zì zhǔ	自律型
宗教	zōng jiào	宗教
宗旨	zōng zhǐ	目的
棕色	zōng sè	褐色
踪迹	zōng jì	痕跡
总而言之	zǒng ér yán zhī	概して
总和	zǒng hé	和
纵横	zòng héng	垂直および水平
走廊	zǒu láng	廊下
走漏	zǒu lòu	リーク
走私	zǒu sī	密輸
揍	zòu	ビート
租赁	zū lìn	リース
足以	zú yǐ	十分
祖父	zǔ fù	祖父
祖国	zǔ guó	祖国
祖先	zǔ xiān	祖先
阻碍	zǔ ài	ヒンダー
阻拦	zǔ lán	やめる
阻挠	zǔ náo	妨害する
钻研	zuān yán	詳細に調べます
钻石	zuàn shí	ダイヤモンド
嘴唇	zuǐ chún	唇
罪犯	zuì fàn	犯罪者
尊严	zūn yán	尊厳
遵循	zūn xún	フォローする
作弊	zuò bì	チート
作废	zuò fèi	ボイド
作风	zuò fēng	スタイル
作息	zuò xī	残り
做主	zuò zhǔ	ショットを呼び出す
座右铭	zuò yòu míng	モットー
