爱情	ài qíng	ស្រឡាញ់
安排	ān pái	ការរៀបចំ
安全	ān quán	សុវត្ថិភាព
按时	àn shí	ទាន់​ពេលវេលា
按照	àn zhào	យោង​ទៅ​តាម
百分之	bǎi fēn zhī	ភាគរយ
棒	bàng	បាតុន
包子	bāo zi	ប៊ុន
保护	bǎo hù	ការការពារ
保证	bǎo zhèng	ធានា
报名	bào míng	ចុះ​ឈ្មោះ
抱	bào	សង្កត់
抱歉	bào qiàn	សុំទោស
倍	bèi	ដង
本来	běn lái	ដើមឡើយ
笨	bèn	ឆោតល្ងង់
比如	bǐ rú	ដូចជា
毕业	bì yè	បញ្ចប់ការសិក្សា
遍	biàn	ពាសពេញ
标准	biāo zhǔn	ស្តង់ដារ
表格	biǎo gé	សំណុំបែបបទ
表示	biǎo shì	មធ្យោបាយ
表演	biǎo yǎn	ការសម្តែង
表扬	biǎo yáng	សរសើរ
饼干	bǐng gān	នំប័រ
并且	bìng qiě	និង
博士	bó shì	បណ្ឌិត
不过	bú guò	ប៉ុន្តែ
不得不	bù dé bù	ត្រូវតែ
不管	bù guǎn	ដោយ​មិន​គិត​ពី
不仅	bù jǐn	មិន​ត្រឹម​តែ
部分	bù fen	ផ្នែក
擦	cā	ជូត
猜	cāi	ទាយ
材料	cái liào	សម្ភារៈ
参观	cān guān	ទស្សនា
餐厅	cān tīng	ភោជនីយដ្ឋាន
厕所	cè suǒ	បន្ទប់ទឹក
差不多	chà bu duō	ស្ទើរតែ
尝	cháng	ភ្លក្សរសជាតិ
长城	cháng chéng	មហា​កំផែង
长江	cháng jiāng	យ៉ាង
场	chǎng	វាល
超过	chāo guò	លើស
乘坐	chéng zuò	ជិះ
成功	chéng gōng	ជោគជ័យ
成为	chéng wéi	ក្លាយជា
诚实	chéng shí	ស្មោះត្រង់
吃惊	chī jīng	ភ្ញាក់ផ្អើល
重新	chóng xīn	ឡើងវិញ
抽烟	chōu yān	ជក់បារី
出差	chū chāi	ដំណើរអាជីវកម្ម
出发	chū fā	ចាប់ផ្ដើម
出生	chū shēng	កើត
出现	chū xiàn	លេចឡើង
厨房	chú fáng	ផ្ទះបាយ
传真	chuán zhēn	ទូរសារ
窗户	chuāng hu	បង្អួច
词语	cí yǔ	ពាក្យ
从来	cóng lái	ធ្លាប់
粗心	cū xīn	ធ្វេសប្រហែស
存	cún	រក្សាទុក
错误	cuò wù	កំហុស
答案	dá àn	ចម្លើយ
打扮	dǎ ban	ស្លៀក​ពាក់​ឡើង
打扰	dǎ rǎo	រំខាន
打印	dǎ yìn	បោះពុម្ព
打招呼	dǎ zhāo hu	ស្វាគមន៍
打折	dǎ zhé	ការបញ្ចុះតម្លៃ
打针	dǎ zhēn	ចាក់
大概	dà gài	ប្រហែលជា
大使馆	dà shǐ guǎn	ស្ថានទូត
大约	dà yuē	អំពី
大夫	dài fu	វេជ្ជបណ្ឌិត
戴	dài	ពាក់
当	dāng	ពេលណា​
当时	dāng shí	បន្ទាប់មក
刀	dāo	កាំបិត
导游	dǎo yóu	ម​គ្គុ​ទេស​ទេសចរ​ណ៏
倒	dào	ដាក់បញ្ច្រាស
到处	dào chù	នៅគ្រប់ទីកន្លែង
到底	dào dǐ	នៅ​ចុងបញ្ចប់
道歉	dào qiàn	សុំទោស
得	dé	ទទួលបាន (កិរិយាស័ព្ទជំនួយ)
得意	dé yì	មានមោទនភាព
登机牌	dēng jī pái	ប័ណ្ណឡើងជិះ
等	děng	ល (ភាគល្អិត)
低	dī	ទាប
底	dǐ	បាត
地点	dì diǎn	ទីតាំង
地球	dì qiú	ផែនដី
地址	dì zhǐ	អាសយដ្ឋាន
掉	diào	ទម្លាក់
调查	diào chá	ការស្ទង់មតិ
丢	diū	បោះ
动作	dòng zuò	សកម្មភាព
堵车	dǔ chē	ស្ទះចរាចរណ៍
肚子	dù zi	ពោះ
短信	duǎn xìn	សារ
对话	duì huà	ការសន្ទនា
对面	duì miàn	ផ្ទុយ
对于	duì yú	សម្រាប់
儿童	ér tóng	កូន
而	ér	និង
发生	fā shēng	កើតឡើង
发展	fā zhǎn	ការអភិវឌ្ឍនៃ
法律	fǎ lv4	ស្របច្បាប់
翻译	fān yì	ការបកប្រែ
烦恼	fán nǎo	តូចចិត្ត
反对	fǎn duì	ប្រឆាំង
方法	fāng fǎ	វិធីសាស្រ្ត
方面	fāng miàn	ទិដ្ឋភាព
方向	fāng xiàng	ទិសដៅ
房东	fáng dōng	ម្ចាស់ដី
放弃	fàng qì	បោះបង់
放暑假	fàng shǔ jià	វិស្សមកាល​រដូវ​ក្តៅ
放松	fàng sōng	សម្រាក
份	fèn	ចែករំលែក
丰富	fēng fù	អ្នកមាន
否则	fǒu zé	បើមិនដូច្នេះទេ
符合	fú hé	ជួប
付款	fù kuǎn	ការទូទាត់
复印	fù yìn	ចម្លង
复杂	fù zá	ស្មុគស្មាញ
富	fù	អ្នកមាន
父亲	fù qīn	ឪពុក
负责	fù zé	ទទួលខុសត្រូវ​ចំពោះ
改变	gǎi biàn	ផ្លាស់ប្តូរ
干杯	gān bēi	លើកទឹកចិត្ត
感动	gǎn dòng	ការផ្លាស់ទីលំនៅ
感觉	gǎn jué	មានអារម្មណ៍
感情	gǎn qíng	អារម្មណ៍
感谢	gǎn xiè	សូមអរគុណ
敢	gǎn	ហ៊ាន
赶	gǎn	ប្រញាប់
干	gàn	ស្ងួត
刚	gāng	គ្រាន់តែ
高速公路	gāo sù gōng lù	ផ្លូវហាយវេ
胳膊	gē bo	ដៃ
各	gè	គ្នា
公里	gōng lǐ	គីឡូម៉ែត្រ
功夫	gōng fu	ការខិតខំ
工资	gōng zī	ប្រាក់ឈ្នួល
共同	gòng tóng	ធម្មតា
够	gòu	គ្រប់គ្រាន់
购物	gòu wù	ការដើរទិញឥវ៉ាន់
估计	gū jì	ប៉ាន់ស្មាន
鼓励	gǔ lì	លើកទឹកចិត្ត
故意	gù yì	ដោយចេតនា
顾客	gù kè	អតិថិជន
挂	guà	ព្យួរ
关键	guān jiàn	ភាពចាំបាច់
观众	guān zhòng	ទស្សនិកជន
管理	guǎn lǐ	ការគ្រប់គ្រង
光	guāng	ពន្លឺ
广播	guǎng bō	ផ្សាយ
广告	guǎng gào	ផ្សាយពាណិជ្ជកម្ម
逛	guàng	ទស្សនា
规定	guī dìng	លលាដ៍ក្បាល
国籍	guó jí	ប្រទេសសញ្ជាតិ
国际	guó jì	អន្តរជាតិ
果汁	guǒ zhī	ទឹក​ផ្លែឈើ
过程	guò chéng	ដំណើរការ
海洋	hǎi yáng	មហាសមុទ្រ
害羞	hài xiū	ខ្មាស់អៀន
寒假	hán jià	វិស្សមកាលរដូវរងារ
汗	hàn	ញើស
航班	háng bān	ការហោះហើរ
好处	hǎo chu	ទទួលបានអត្ថប្រយោជន៍
好像	hǎo xiàng	ចូលចិត្ត
号码	hào mǎ	ចំនួន
合格	hé gé	មានលក្ខណៈសម្បត្តិគ្រប់គ្រាន់
合适	hé shì	សមរម្យ
盒子	hé zi	ប្រអប់
厚	hòu	ក្រាស់
后悔	hòu huǐ	សោកស្តាយ
互联网	hù lián wǎng	អ៊ីនធឺណិត
互相	hù xiāng	ទៅវិញទៅមក
护士	hù shi	គិលានុបដ្ឋាយិកា
怀疑	huái yí	សង្ស័យ
回忆	huí yì	អនុស្សាវរីយ៍
活动	huó dòng	សកម្មភាព
活泼	huó po	រស់រវើក
火	huǒ	ភ្លើង
获得	huò dé	ទទួលបាន
基础	jī chǔ	មូលដ្ឋាន
激动	jī dòng	រំភើប
积极	jī jí	វិជ្ជមាន
积累	jī lěi	កកកុញ
即使	jí shǐ	បើ​ទោះ​បី​ជា
及时	jí shí	ទាន់ពេលវេលា
寄	jì	ផ្ញើ
技术	jì shù	បច្ចេកវិទ្យា
既然	jì rán	ចាប់តាំងពី
继续	jì xù	អនុវត្តលើ
计划	jì huà	ផែនការ
记者	jì zhě	អ្នកយកព័ត៌មាន
加班	jiā bān	ហួសពេល
加油站	jiā yóu zhàn	ឧស្ម័ន
家具	jiā jù	គ្រឿងសង្ហារឹម
假	jiǎ	មិនពិត
价格	jià gé	តម្លៃ
坚持	jiān chí	ប្រកាន់ខ្ជាប់
减肥	jiǎn féi	ស្រក​ទម្ងន់
减少	jiǎn shǎo	កាត់ត្រឡប់មកវិញ
建议	jiàn yì	សំណូមពរ
将来	jiāng lái	អនាគត
奖金	jiǎng jīn	ប្រាក់រង្វាន់
降低	jiàng dī	កាត់បន្ថយ
降落	jiàng luò	ចុះចត
交	jiāo	ឈើឆ្កាង
交流	jiāo liú	ទំនាក់ទំនង​ជាមួយ
交通	jiāo tōng	ចរាចរណ៍
郊区	jiāo qū	តំបន់ជាយក្រុង
骄傲	jiāo ào	មានមោទនភាព
饺子	jiǎo zi	នំប៉ាវ
教授	jiào shòu	សាស្រ្តាចារ្យ
教育	jiào yù	ការអប់រំ
接受	jiē shòu	ទទួលយក
接着	jiē zhe	បន្ទាប់មក
结果	jié guǒ	លទ្ធផល
节	jié	ផ្នែក
节约	jié yuē	សន្សំ
解释	jiě shì	ការពន្យល់
尽管	jǐn guǎn	ទោះជា
紧张	jǐn zhāng	ភាពតានតឹង
禁止	jìn zhǐ	ហាមឃាត់
进行	jìn xíng	ទទួលបាននៅលើ
京剧	jīng jù	ល្ខោន peking
精彩	jīng cǎi	អស្ចារ្យ
经济	jīng jì	សេដ្ឋកិច្ច
经历	jīng lì	បទពិសោធន៍
经验	jīng yàn	បទពិសោធន៍
景色	jǐng sè	មើល
警察	jǐng chá	ប៉ូលីស
竞争	jìng zhēng	ការប្រកួតប្រជែង
竟然	jìng rán	ពិត
镜子	jìng zi	កញ្ចក់
究竟	jiū jìng	យ៉ាង​ពិតប្រាកដ
举	jǔ	លើក
举办	jǔ bàn	សង្កត់
举行	jǔ xíng	សង្កត់
拒绝	jù jué	បដិសេធ
聚会	jù huì	រួមគ្នា
距离	jù lí	ចម្ងាយ
开玩笑	kāi wán xiào	កំប្លែង
开心	kāi xīn	រីករាយ
看法	kàn fǎ	មើល
烤鸭	kǎo yā	ទាអាំង
考虑	kǎo lv4	ពិចារណា
棵	kē	ដើមឈើ
科学	kē xué	វិទ្យាសាស្ត្រ
咳嗽	ké sou	ក្អក
可怜	kě lián	អាណិតអាសូរ
可是	kě shì	ប៉ុន្តែ
可惜	kě xī	ជាអកុសល
客厅	kè tīng	បន្ទប់ទទួលភ្ញៀវ
肯定	kěn dìng	ប្រាកដ
空	kōng	ខ្យល់
空气	kōng qì	ខ្យល់
恐怕	kǒng pà	ខ្ញុំ​ខ្លាច
苦	kǔ	ជូរចត់
矿泉水	kuàng quán shuǐ	ទឹកបរិសុទ្ធ
困	kùn	ងងុយគេង
困难	kùn nan	ពិបាក
垃圾桶	lā jī tǒng	ធុងសំរាម
拉	lā	ទាញ
辣	là	ក្តៅ
来不及	lái bu jí	យឺត​ណាស់
来得及	lái de jí	យឺត​ណាស់
来自	lái zì	ពី
懒	lǎn	ខ្ជិល
浪费	làng fèi	ខ្ជះខ្ជាយ
浪漫	làng màn	មនោសញ្ចេតនា
老虎	lǎo hǔ	ខ្លា
冷静	lěng jìng	ស្ងប់ស្ងាត់
理发	lǐ fà	កាត់សក់
理解	lǐ jiě	ការយល់ដឹង
理想	lǐ xiǎng	ល្អបំផុត
礼拜天	lǐ bài tiān	ថ្ងៃអាទិត្យ
礼貌	lǐ mào	សុភាពរាបសា
例如	lì rú	ឧ
力气	lì qi	កម្លាំង
厉害	lì hai	អស្ចារ្យ
俩	liǎ	ទាំងពីរ
联系	lián xì	ទំនាក់ទំនង
连	lián	សូម្បីតែ
凉快	liáng kuai	ត្រជាក់
零钱	líng qián	ការផ្លាស់ប្តូរតិចតួច
另外	lìng wài	លើស​ពី​នេះ​ទៀត
流利	liú lì	ស្ទាត់
流行	liú xíng	ពេញនិយម
留	liú	ស្នាក់នៅ
旅行	lǚ xíng	ធ្វើដំណើរ
乱	luàn	ភាពវឹកវរ
律师	lv4 shī	មេធាវី
麻烦	má fan	បញ្ហា
马虎	mǎ hu	ធ្វេសប្រហែស
满	mǎn	ពេញ
毛	máo	សក់
毛巾	máo jīn	កន្សែង
美丽	měi lì	ស្រស់ស្អាត
梦	mèng	សុបិន្ត
迷路	mí lù	វង្វេង​ផ្លូវ
密码	mì mǎ	ពាក្យសម្ងាត់
免费	miǎn fèi	ឥតគិតថ្លៃ
秒	miǎo	ទីពីរ
民族	mín zú	ជាតិ
母亲	mǔ qīn	ម្តាយ
目的	mù dì	គោលបំណង
耐心	nài xīn	អ្នកជំងឺ
难道	nán dào	គឺវា
难受	nán shòu	មិនស្រួល
内	nèi	នៅខាងក្នុង
内容	nèi róng	មាតិកា
能力	néng lì	សមត្ថភាព
年龄	nián líng	អាយុ
弄	nòng	ធ្វើ
暖和	nuǎn huo	កក់ក្តៅ
偶尔	ǒu ěr	ម្តងម្កាល
排队	pái duì	ជួរ
排列	pái liè	ការរៀបចំ
判断	pàn duàn	ការវិនិច្ឆ័យ
陪	péi	រួមដំណើរជាមួយ
批评	pī píng	ការរិះគន់
皮肤	pí fū	ស្បែក
脾气	pí qi	កំហឹង
篇	piān	អត្ថបទ
骗	piàn	បោក
乒乓球	pīng pāng qiú	ពីងប៉ុង
平时	píng shí	ជាធម្មតា
破	pò	ខូច
葡萄	pú tao	ទំពាំងបាយជូរ
普遍	pǔ biàn	ជាសកល
普通话	pǔ tōng huà	ភាសាចិនកុកងឺ
其次	qí cì	ទីពីរ
其中	qí zhōng	ក្នុងចំណោម​ពួកគេ
气候	qì hòu	អាកាសធាតុ
千万	qiān wàn	ដប់លាន
签证	qiān zhèng	ទិដ្ឋាការ
敲	qiāo	គោះ
桥	qiáo	ស្ពាន
巧克力	qiǎo kè lì	សូកូឡា
亲戚	qīn qi	សាច់ញាតិ
轻	qīng	ពន្លឺ
轻松	qīng sōng	ងាយស្រួល
情况	qíng kuàng	កំពុងកើតឡើង
穷	qióng	ក្រីក្រ
区别	qū bié	ភាព​ខុសគ្នា
取	qǔ	យក
全部	quán bù	ទាំងអស់
缺点	quē diǎn	គុណវិបត្តិ
缺少	quē shǎo	ខ្វះខាត
却	què	ប៉ុន្តែ
确实	què shí	ជា​ការ​ពិត
然而	rán ér	ទោះយ៉ាងណាក៏ដោយ
热闹	rè nao	រស់រវើក
任何	rèn hé	ណាមួយ
任务	rèn wu	ភារកិច្ច
扔	rēng	បោះ
仍然	réng rán	នៅតែមាន
日记	rì jì	កំណត់ហេតុប្រចាំថ្ងៃ
入口	rù kǒu	ច្រកចូល
散步	sàn bù	ដើរលេង
森林	sēn lín	ព្រៃ
沙发	shā fā	សាឡុង
伤心	shāng xīn	សោកសៅ
商量	shāng liang	ពិភាក្សា
稍微	shāo wēi	តិចតួច
勺子	sháo zi	ស្លាបព្រា
社会	shè huì	សង្គម
深	shēn	ជ្រៅ
申请	shēn qǐng	ពាក្យសុំ
甚至	shèn zhì	សូម្បីតែ
生活	shēng huó	ជីវិត
生命	shēng mìng	ជីវិត
生意	shēng yì	អាជីវកម្ម
省	shěng	ខេត្ត
剩	shèng	នៅសល់
失败	shī bài	ការបរាជ័យ
失望	shī wàng	ខកចិត្ត
师傅	shī fu	មេ
十分	shí fēn	ខ្លាំងណាស់
实际	shí jì	ពិតប្រាកដ
实在	shí zài	ពិតជា
使	shǐ	ធ្វើ
使用	shǐ yòng	ប្រើ
世纪	shì jì	សតវត្សទី
是否	shì fǒu	ថាតើ
适合	shì hé	សាកសមសម្រាប់
适应	shì yìng	សម្របខ្លួន
收	shōu	ទទួល
收入	shōu rù	ប្រាក់ចំណូល
收拾	shōu shi	ខ្ចប់
首都	shǒu dū	ដើមទុន
首先	shǒu xiān	ជា​ដំបូងបង្អស់
受不了	shòu bù liǎo	មិនអាចទ្រាំបាន
受到	shòu dào	រងទុក្ខ
售货员	shòu huò yuán	អ្នកលក់
输	shū	ចាញ់
熟悉	shú xī	ស៊ាំ​ជាមួយ
数量	shù liàng	បរិមាណ
数字	shù zì	ឌីជីថល
帅	shuài	សង្ហា
顺便	shùn biàn	និយាយ​អញ្ចឹង
顺利	shùn lì	ដោយរលូន
顺序	shùn xù	សណ្តាប់ធ្នាប់
说明	shuō míng	ការពិពណ៌នា
硕士	shuò shì	ថ្នាក់អនុបណ្ឌិត
死	sǐ	ស្លាប់
塑料袋	sù liào dài	ថង់ប្លាស្ទិច
速度	sù dù	ល្បឿន
酸	suān	អាសុីត
随便	suí biàn	ធម្មតា
随着	suí zhe	រួមជាមួយ
孙子	sūn zi	ចៅប្រុស
所有	suǒ yǒu	ទាំងអស់
台	tái	ស្ថានីយ៍
抬	tái	លើក
态度	tài du	ឥរិយាបថ
弹钢琴	tán gāng qín	លេងព្យាណូ
谈	tán	និយាយ
汤	tāng	ស៊ុប
糖	táng	ស្ករ
躺	tǎng	ដេក
趟	tàng	ការធ្វើដំណើរ
讨论	tǎo lùn	ពិភាក្សា
讨厌	tǎo yàn	ស្អប់
特点	tè diǎn	លក្ខណៈពិសេស
提	tí	និយាយ
提供	tí gōng	ផ្តល់
提前	tí qián	ទុកជាមុន
提醒	tí xǐng	រំ.ក
填空	tián kòng	បំពេញក្នុងចន្លោះទទេ
条件	tiáo jiàn	លក្ខខណ្ឌ
停	tíng	បញ្ឈប់
挺	tǐng	ខ្លាំងណាស់
通过	tōng guò	ដោយ
通知	tōng zhī	សេចក្តីជូនដំណឹង
同情	tóng qíng	ការអាណិតអាសូរ
同时	tóng shí	ដំណាលគ្នា
推	tuī	ជំរុញ
推迟	tuī chí	ដាក់ចេញ
脱	tuō	យកចេញ
袜子	wà zi	ស្រោមជើង
完全	wán quán	បញ្ចប់
往往	wǎng wǎng	ជាញឹកញាប់
网球	wǎng qiú	កីឡាវាយកូនបាល់
网站	wǎng zhàn	គេហទំព័រ
危险	wēi xiǎn	គ្រោះថ្នាក់
卫生间	wèi shēng jiān	បន្ទប់ទឹក
味道	wèi dào	ភ្លក្សរសជាតិ
温度	wēn dù	សីតុណ្ហាភាព
文章	wén zhāng	អត្ថបទ
污染	wū rǎn	ការបំពុល
无	wú	ទេ
无聊	wú liáo	អផ្សុក
无论	wú lùn	ដោយមិនគិត
误会	wù huì	ការយល់ច្រឡំ
吸引	xī yǐn	ទាក់ទាញ
西红柿	xī hóng shì	ប៉េងប៉ោះ
咸	xián	ប្រៃ
现金	xiàn jīn	សាច់ប្រាក់
羡慕	xiàn mù	ការច្រណែន
相反	xiāng fǎn	ផ្ទុយ​មកវិញ
相同	xiāng tóng	ដូច​គ្នា
香	xiāng	ក្រអូប
详细	xiáng xì	លម្អិត
响	xiǎng	រោទិ៍
橡皮	xiàng pí	កៅស៊ូ
消息	xiāo xi	ព័ត៌មាន
小吃	xiǎo chī	អាហារសម្រន់
小伙子	xiǎo huǒ zi	ឡាដ
小说	xiǎo shuō	រឿងប្រឌិត
效果	xiào guǒ	ផលប៉ះពាល់
笑话	xiào huà	កំប្លែង
心情	xīn qíng	អារម្មណ៍
辛苦	xīn kǔ	រឹង
信封	xìn fēng	ស្រោមសំបុត្រ
信息	xìn xī	ព័ត៌មាន
信心	xìn xīn	ទំនុកចិត្ត
兴奋	xīng fèn	រំភើប
行	xíng	ជួរដេក
醒	xǐng	ភ្ញាក់
幸福	xìng fú	រីករាយ
性别	xìng bié	ភេទ
性格	xìng gé	តួអក្សរ
修理	xiū lǐ	ជួសជុល
许多	xǔ duō	ច្រើន
学期	xué qī	ឆមាស
呀	ya	យាយ
压力	yā lì	សម្ពាធ
牙膏	yá gāo	ថ្នាំដុសធ្មេញ
亚洲	yà zhōu	អាស៊ី
严格	yán gé	តឹងរឹង
严重	yán zhòng	ធ្ងន់ធ្ងរ
盐	yán	អំបិល
研究	yán jiū	ការសិក្សា
演出	yǎn chū	បង្ហាញ
演员	yǎn yuán	តារាសម្តែង
眼镜	yǎn jìng	វ៉ែនតា
阳光	yáng guāng	ពន្លឺព្រះអាទិត្យ
养成	yǎng chéng	អភិវឌ្ឍ
样子	yàng zi	មើលទៅដូចជា
邀请	yāo qǐng	អញ្ជើញ
要是	yào shi	ប្រសិនបើ
钥匙	yào shi	កូនសោ
也许	yě xǔ	ប្រហែល
叶子	yè zi	ស្លឹក
页	yè	ទំព័រ
一切	yī qiè	ទាំងអស់
以	yǐ	ទៅ
以为	yǐ wéi	គិត
意见	yì jiàn	មតិ
艺术	yì shù	សិល្បៈ
因此	yīn cǐ	ដូច្នេះ
引起	yǐn qǐ	មូលហេតុ
印象	yìn xiàng	ចំណាប់អារម្មណ៍
赢	yíng	ឈ្នះ
应聘	yìng pìn	ដាក់ពាក្យ​សម្រាប់
勇敢	yǒng gǎn	ក្លាហាន
永远	yǒng yuǎn	ជា​រាង​រហូត​និង​ជានិច្ច
优点	yōu diǎn	អត្ថប្រយោជន៍
优秀	yōu xiù	ល្អបំផុត
幽默	yōu mò	ការលេងសើច
尤其	yóu qí	ជាពិសេស
由	yóu	ដោយ
由于	yóu yú	ដោយ​សារ​តែ​ការ
邮局	yóu jú	ការិយាល័យ​ប្រៃសណីយ៍
友好	yǒu hǎo	រាក់ទាក់
友谊	yǒu yì	មិត្តភាព
有趣	yǒu qù	គួរឱ្យចាប់អារម្មណ៍
于是	yú shì	បន្ទាប់មក
愉快	yú kuài	រីករាយ
与	yǔ	ប្រឆាំង​នឹង​ទល់​នឹង
羽毛球	yǔ máo qiú	កីឡាវាយសី
语法	yǔ fǎ	វេយ្យាករណ៍
语言	yǔ yán	ភាសា
预习	yù xí	មើលជាមុន
原来	yuán lái	ដើម
原谅	yuán liàng	អត់ទោស
原因	yuán yīn	ហេតុផល
约会	yuē huì	ការណាត់ជួប
阅读	yuè dú	អាន
云	yún	ពពក
允许	yǔn xǔ	អនុញ្ញាត
杂志	zá zhì	ទស្សនាវដ្តី
咱们	zán men	យើង
暂时	zàn shí	បណ្តោះអាសន្ន
脏	zāng	កខ្វក់
责任	zé rèn	ការទទួលខុសត្រូវ
增加	zēng jiā	កើនឡើង
占线	zhàn xiàn	រវល់
招聘	zhāo pìn	ការជ្រើសរើសបុគ្គលិក
照	zhào	យោង​ទៅ​តាម
真正	zhēn zhèng	ពិតប្រាកដ
整理	zhěng lǐ	តម្រៀបចេញ
正常	zhèng cháng	ធម្មតា
正好	zhèng hǎo	ត្រឹមត្រូវ
正确	zhèng què	ត្រឹមត្រូវ
正式	zhèng shì	ជាផ្លូវការ
证明	zhèng míng	បង្ហាញ
之	zhī	នៃ
支持	zhī chí	ប្រចាំ​ការ
知识	zhī shi	ចំណេះដឹង
值得	zhí de	សមនឹងវា
植物	zhí wù	រុក្ខជាតិ
直接	zhí jiē	ដោយផ្ទាល់
职业	zhí yè	វិជ្ជាជីវៈ
只好	zhǐ hǎo	ត្រូវតែ
只要	zhǐ yào	ដរាបណា
指	zhǐ	មធ្យោបាយ
至少	zhì shǎo	យ៉ាងហោចណាស់
质量	zhì liàng	គុណភាព
重	zhòng	ទំងន់
重点	zhòng diǎn	ផ្តោតអារម្មណ៍
重视	zhòng shì	តម្លៃ
周围	zhōu wéi	នៅជុំវិញ
主意	zhǔ yi	គំនិត
祝贺	zhù hè	អបអរសាទរ
著名	zhù míng	ល្បីល្បាញ
专门	zhuān mén	ឯកទេស
专业	zhuān yè	វិជ្ជាជីវៈ
转	zhuǎn	វេន
赚	zhuàn	រកបាន
准确	zhǔn què	ត្រឹមត្រូវ
准时	zhǔn shí	ទាន់​ពេលវេលា
仔细	zǐ xì	ប្រយ័ត្ន
自然	zì rán	ធម្មជាតិ
自信	zì xìn	ទំនុកចិត្ត
总结	zǒng jié	ដើម្បី​សរុប
租	zū	ជួល
最好	zuì hǎo	ល្អ​បំផុត
尊重	zūn zhòng	ការគោរព
左右	zuǒ yòu	អំពី
作家	zuò jiā	អ្នកនិពន្ធ
作用	zuò yòng	ផលប៉ះពាល់
作者	zuò zhě	អ្នកនិពន្ធ
座	zuò	កៅអី
座位	zuò wèi	កៅអី
