挨	ái	soffrire
癌症	ái zhèng	cancro
暧昧	ài mèi	ambiguo
爱不释手	ài bù shì shǒu	posalo
爱戴	ài dài	amore
安宁	ān níng	tranquillo, calmo
安详	ān xiáng	sereno
安置	ān zhì	posizionamento
按摩	àn mó	massaggio
暗示	àn shì	suggerimento
案件	àn jiàn	astuccio
案例	àn lì	astuccio
昂贵	áng guì	costoso
凹凸	āo tū	bump
熬	áo	bollire
奥秘	ào mì	mistero
巴不得	bā bù dé	ansioso
巴结	bā jie	fulvo
扒	bā	griglia
疤	bā	cicatrice
拔苗助长	bá miáo zhù zhǎng	sradicamento
把关	bǎ guān	dai un'occhiata
把手	bǎ shǒu	maniglia
罢工	bà gōng	sciopero
霸道	bà dào	prepotente
掰	bāi	ciao
摆脱	bǎi tuō	liberarsi di
拜访	bài fǎng	visita
拜年	bài nián	felice anno nuovo
拜托	bài tuō	per favore
败坏	bài huài	corrotto
斑	bān	individuare
颁布	bān bù	promulgare
颁发	bān fā	problema
版本	bǎn běn	versione
伴侣	bàn lv3	compagno
伴随	bàn suí	accompagnando
半途而废	bàn tú ér fèi	rinunciare a metà strada
扮演	bàn yǎn	giocare
榜样	bǎng yàng	esempio
绑架	bǎng jià	rapimento
磅	bàng	libbre
包庇	bāo bì	riparo
包袱	bāo fu	fardello
包围	bāo wéi	circondato
包装	bāo zhuāng	pacchetto
保管	bǎo guǎn	custodia
保密	bǎo mì	tieni segreto
保姆	bǎo mǔ	baby-sitter
保守	bǎo shǒu	conservatore
保卫	bǎo wèi	difendere
保养	bǎo yǎng	manutenzione
保障	bǎo zhàng	garanzia
保重	bǎo zhòng	stai attento
饱和	bǎo hé	saturazione
饱经沧桑	bǎo jīng cāng sāng	vicissitudini
报酬	bào chou	compenso
报仇	bào chóu	vendetta
报答	bào dá	rimborsare
报复	bào fù	vendetta
报警	bào jǐng	chiama la polizia
报销	bào xiāo	rimborso
抱负	bào fù	ambizione
暴力	bào lì	violenza
暴露	bào lù	esposto
曝光	bào guāng	esposizione
爆发	bào fā	scoppiare
爆炸	bào zhà	esplosione
卑鄙	bēi bǐ	significare
悲哀	bēi āi	tristezza
悲惨	bēi cǎn	tragico
北极	běi jí	artico
备份	bèi fèn	backup
备忘录	bèi wàng lù	memorandum
背叛	bèi pàn	tradire
背诵	bèi sòng	recitare
被动	bèi dòng	passivo
被告	bèi gào	imputato
贝壳	bèi ké	conchiglia
奔波	bēn bō	corri in giro
奔驰	bēn chí	benz
本能	běn néng	istinto
本钱	běn qián	capitale
本人	běn rén	me stessa
本身	běn shēn	si
本事	běn shi	capacità
笨拙	bèn zhuō	goffo
崩溃	bēng kuì	crollo
甭	béng	non farlo
蹦	bèng	saltare
迸发	bèng fā	burst
逼迫	bī pò	vigore
鼻涕	bí tì	naso
比方	bǐ fang	per esempio
比喻	bǐ yù	metafora
比重	bǐ zhòng	proporzione
鄙视	bǐ shì	disprezzare
弊病	bì bìng	malessere
弊端	bì duān	svantaggi
臂	bì	braccio
闭塞	bì sè	occludere
编织	biān zhī	tessere
边疆	biān jiāng	frontiera
边界	biān jiè	confine
边境	biān jìng	confine
边缘	biān yuán	bordo
鞭策	biān cè	sperone
扁	biǎn	piatto
贬低	biǎn dī	sminuire
贬义	biǎn yì	derogatorio
便利	biàn lì	conveniente
便条	biàn tiáo	nota
便于	biàn yú	facile da
变故	biàn gù	sfortuna
变迁	biàn qiān	modificare
变质	biàn zhì	deterioramento
辨认	biàn rèn	identificare
辩护	biàn hù	difendere
辩解	biàn jiě	scusa
辩证	biàn zhèng	dialettico
辫子	biàn zi	treccia
遍布	biàn bù	ovunque
标本	biāo běn	campione
标记	biāo jì	marchio
标题	biāo tí	titolo
表决	biǎo jué	votazione
表态	biǎo tài	posizione
表彰	biǎo zhāng	riconoscimento
憋	biē	trattenere
别墅	bié shù	villa
别致	bié zhì	chic
别扭	biè niu	imbarazzante
濒临	bīn lín	sul punto di
冰雹	bīng báo	grandine
丙	bǐng	c
并非	bìng fēi	non
并列	bìng liè	fianco a fianco
剥削	bō xuē	sfruttare
拨	bō	comporre
播种	bō zhòng	semina
波浪	bō làng	onda
波涛	bō tāo	onde
伯母	bó mǔ	zia
博大精深	bó dà jīng shēn	ampio e profondo
博览会	bó lǎn huì	giusto
搏斗	bó dòu	combattimento
薄弱	bó ruò	debole
不顾	bú gù	indipendentemente da
不愧	bú kuì	meritevole di
不料	bú liào	inaspettatamente
不像话	bú xiàng huà	oltraggioso
不屑一顾	bú xiè yī gù	sbrigativo
哺乳	bǔ rǔ	l'allattamento al seno
捕捉	bǔ zhuō	catturare
补偿	bǔ cháng	trucco
补救	bǔ jiù	rimedio
补贴	bǔ tiē	sussidio
不得已	bù dé yǐ	ultima risorsa
不妨	bù fáng	potrebbe pure
不敢当	bù gǎn dāng	non osare essere
不禁	bù jīn	non posso aiutare
不堪	bù kān	insopportabile
不可思议	bù kě sī yì	incredibile
不免	bù miǎn	inevitabilmente
不时	bù shí	di volta in volta
不惜	bù xī	non esitare
不相上下	bù xiāng shàng xià	paragonabile
不言而喻	bù yán ér yù	va da sé
不由得	bù yóu de	non posso fare a meno
不择手段	bù zé shǒu duàn	gioca duro
不止	bù zhǐ	più di
布告	bù gào	avviso
布局	bù jú	disposizione
布置	bù zhì	disposizione
步伐	bù fá	ritmo
部署	bù shǔ	distribuire
部位	bù wèi	posizione
才干	cái gàn	competenza
裁缝	cái feng	sarto
裁判	cái pàn	arbitro
裁员	cái yuán	licenziamenti
财富	cái fù	ricchezza
财务	cái wù	finanza
财政	cái zhèng	finanziario
彩票	cǎi piào	lotteria
采购	cǎi gòu	acquista
采集	cǎi jí	collezione
采纳	cǎi nà	adozione
参谋	cān móu	personale
参照	cān zhào	riferimento
残疾	cán jí	disabilità
残酷	cán kù	crudele
残留	cán liú	residuo
残忍	cán rěn	crudele
灿烂	càn làn	brillante
仓促	cāng cù	frettoloso
仓库	cāng kù	magazzino
舱	cāng	cabina
苍白	cāng bái	pallido
操劳	cāo láo	lavorare duramente
操练	cāo liàn	pratica
操纵	cāo zòng	manipolare
操作	cāo zuò	operativo
嘈杂	cáo zá	rumoroso
草案	cǎo àn	bozza
草率	cǎo shuài	frettoloso
侧面	cè miàn	lato
测量	cè liáng	misurazione
策划	cè huà	piano
策略	cè lvè	strategia
层出不穷	céng chū bù qióng	infinito
层次	céng cì	livello
差别	chā bié	differenza
插座	chā zuò	presa
查获	chá huò	sequestrato
刹那	chà nà	momento
岔	chà	forchetta
诧异	chà yì	sorpreso
柴油	chái yóu	diesel
搀	chān	mescolare
缠绕	chán rào	avvolgimento
馋	chán	avido
产业	chǎn yè	industria
阐述	chǎn shù	elaborare
颤抖	chàn dǒu	tremito
昌盛	chāng shèng	prosperità
偿还	cháng huán	rimborsare
尝试	cháng shì	provare
场合	chǎng hé	occasione
场面	chǎng miàn	scena
场所	chǎng suǒ	posto
敞开	chǎng kāi	spalancata
倡导	chàng dǎo	avvocato
倡议	chàng yì	iniziativa
畅通	chàng tōng	sbloccato
畅销	chàng xiāo	il più venduto
超越	chāo yuè	al di là
钞票	chāo piào	banconota
嘲笑	cháo xiào	affilare i denti
巢穴	cháo xué	nido
朝代	cháo dài	dinastia
潮流	cháo liú	tendenza
撤退	chè tuì	ritiro
撤销	chè xiāo	revocare
沉淀	chén diàn	precipitazione
沉闷	chén mèn	noioso
沉思	chén sī	meditazione
沉重	chén zhòng	pesante
沉着	chén zhuó	calma
陈旧	chén jiù	obsoleto
陈列	chén liè	schermo
陈述	chén shù	dichiarazione
称心如意	chèn xīn rú yì	soddisfacente
衬托	chèn tuō	partire
称号	chēng hào	titolo
乘	chéng	moltiplicare
呈现	chéng xiàn	presente
城堡	chéng bǎo	castello
惩罚	chéng fá	punizione
成本	chéng běn	costo
成交	chéng jiāo	affare
成天	chéng tiān	tutto il giorno
成效	chéng xiào	efficacia
成心	chéng xīn	deliberatamente
成员	chéng yuán	membro
承办	chéng bàn	intraprendere
承包	chéng bāo	contrarre
承诺	chéng nuò	impegnato con
橙	chéng	arancia
澄清	chéng qīng	chiarire
盛	chéng	sheng
诚挚	chéng zhì	sincero
秤	chèng	bilancia
吃苦	chī kǔ	soffrire
吃力	chī lì	faticoso
持久	chí jiǔ	duraturo
迟钝	chí dùn	lento
迟缓	chí huǎn	lento
迟疑	chí yí	esitare
赤道	chì dào	equatoriale
赤字	chì zì	disavanzo
充当	chōng dāng	agire come
充沛	chōng pèi	abbondante
充实	chōng shí	arricchire
充足	chōng zú	adeguato
冲动	chōng dòng	impulso
冲击	chōng jī	shock
冲突	chōng tū	conflitto
崇拜	chóng bài	culto
崇高	chóng gāo	sublime
崇敬	chóng jìng	rispetto
重叠	chóng dié	sovrapposizione
稠密	chóu mì	denso
筹备	chóu bèi	preparazione
丑恶	chǒu è	brutto
出路	chū lù	via d'uscita
出卖	chū mài	vendere
出身	chū shēn	origine
出神	chū shén	trance
出息	chū xi	eccezionale
初步	chū bù	preliminare
除	chú	tranne
储备	chǔ bèi	riserva
储存	chǔ cún	negozio
储蓄	chǔ xù	risparmio
处分	chǔ fèn	sanzione
处境	chǔ jìng	situazione
处置	chǔ zhì	smaltire
触犯	chù fàn	offendere
川流不息	chuān liú bù xī	flusso costante
穿越	chuān yuè	attraversare
传达	chuán dá	trasmettere
传单	chuán dān	volantino
传授	chuán shòu	insegnare
船舶	chuán bó	nave
喘气	chuǎn qì	ansimare
串	chuàn	corda
床单	chuáng dān	lenzuolo
创立	chuàng lì	fondato
创新	chuàng xīn	innovazione
创业	chuàng yè	iniziare un attività
创作	chuàng zuò	creazione
吹牛	chuī niú	vantarsi
吹捧	chuī pěng	lusingare
炊烟	chuī yān	fumo di cottura
垂直	chuí zhí	verticale
锤	chuí	martello
纯粹	chún cuì	puramente
纯洁	chún jié	puro
慈善	cí shàn	caritatevole
慈祥	cí xiáng	cortesemente
磁带	cí dài	nastro
雌雄	cí xióng	maschio e femmina
伺候	cì hòu	servire
刺	cì	spina
次品	cì pǐn	difettoso
次序	cì xù	ordine
丛	cóng	clump
从容	cóng róng	con calma
凑合	còu he	improvvisare
粗鲁	cū lǔ	maleducato
窜	cuàn	canale
摧残	cuī cán	devastazione
脆弱	cuì ruò	fragile
搓	cuō	torcere
磋商	cuō shāng	consultazione
挫折	cuò zhé	frustrazione
搭	dā	prendere
搭档	dā dàng	compagno
搭配	dā pèi	incontro
答辩	dá biàn	rispondere
答复	dá fù	rispondere
达成	dá chéng	raggiungere
打包	dǎ bāo	balla
打官司	dǎ guān si	contenzioso
打击	dǎ jī	soffio
打架	dǎ jià	combattimento
打量	dǎ liang	guarda a
打猎	dǎ liè	caccia
打仗	dǎ zhàng	combattimento
大不了	dà bù liǎo	grande affare
大臣	dà chén	ministro
大伙儿	dà huǒ r	tutti
大肆	dà sì	sfrenatamente
大体	dà tǐ	in generale
大意	dà yì	idea principale
大致	dà zhì	circa
歹徒	dǎi tú	gangster
代价	dài jià	costo
代理	dài lǐ	proxy
带领	dài lǐng	condurre
怠慢	dài màn	trascurare
逮捕	dài bǔ	arresto
担保	dān bǎo	garanzia
胆怯	dǎn qiè	timido
淡季	dàn jì	fuori stagione
淡水	dàn shuǐ	acqua dolce
蛋白质	dàn bái zhì	proteina
诞辰	dàn chén	compleanno
诞生	dàn shēng	nato
当场	dāng chǎng	sul posto
当初	dāng chū	all'inizio
当代	dāng dài	contemporaneo
当面	dāng miàn	faccia a faccia
当前	dāng qián	attuale
当事人	dāng shì rén	festa
当务之急	dāng wù zhī jí	imperativo
当选	dāng xuǎn	eletto
党	dǎng	festa
档案	dàng àn	file
档次	dàng cì	grado
倒闭	dǎo bì	crollo
导弹	dǎo dàn	missile
导航	dǎo háng	navigazione
导向	dǎo xiàng	guida
捣乱	dǎo luàn	creare difficoltà
盗窃	dào qiè	furto
稻谷	dào gǔ	risaia
得不偿失	dé bù cháng shī	non ne vale la pena
得力	dé lì	efficace
得天独厚	dé tiān dú hòu	benedetto
得罪	dé zuì	offendere
灯笼	dēng lóng	lanterna
登录	dēng lù	accesso
登陆	dēng lù	registrati
蹬	dēng	calcio
等候	děng hòu	in attesa
等级	děng jí	grado
瞪	dèng	fissare
堤坝	dī bà	diga
敌视	dí shì	ostile
抵达	dǐ dá	arrivo
抵抗	dǐ kàng	resistenza
抵制	dǐ zhì	resistere
地步	dì bù	punto
地势	dì shì	terreno
地质	dì zhì	geologia
递增	dì zēng	aumentare
颠簸	diān bǒ	dossi
颠倒	diān dǎo	inversione
典礼	diǎn lǐ	cerimonia
典型	diǎn xíng	tipico
点缀	diǎn zhuì	abbellimento
垫	diàn	pad
奠定	diàn dìng	posare
惦记	diàn jì	preoccuparsi di
电源	diàn yuán	alimentazione elettrica
叼	diāo	penzolare
雕刻	diāo kè	scultura
雕塑	diāo sù	scultura
吊	diào	appendere
调动	diào dòng	mobilitare
跌	diē	autunno
丁	dīng	ding
叮嘱	dīng zhǔ	esortare
盯	dīng	fissare
定期	dìng qī	regolare
定义	dìng yì	definizione
丢人	diū rén	vergogna
丢三落四	diū sān là sì	perdi tutto
东道主	dōng dào zhǔ	ospite
东张西望	dōng zhāng xī wàng	guardando intorno
董事长	dǒng shì zhǎng	presidente
冻结	dòng jié	congelare
动荡	dòng dàng	tumulto
动机	dòng jī	motivazione
动静	dòng jìng	movimento
动力	dòng lì	energia
动脉	dòng mài	arteria
动身	dòng shēn	partire
动手	dòng shǒu	mani su
动态	dòng tài	dinamico
动员	dòng yuán	mobilitazione
栋	dòng	dong
兜	dōu	tasca
陡峭	dǒu qiào	ripida
斗争	dòu zhēng	lotta
督促	dū cù	sollecitare
毒品	dú pǐn	farmaco
独裁	dú cái	dittatura
堵塞	dǔ sè	blocco
赌博	dǔ bó	gioco d'azzardo
杜绝	dù jué	mettere fine a
端	duān	fine
端午节	duān wǔ jié	festival delle barche del drago
端正	duān zhèng	corretta
短促	duǎn cù	corto
断定	duàn dìng	determinare
断绝	duàn jué	tagliato fuori
堆积	duī jī	accumulo
兑现	duì xiàn	contanti
对策	duì cè	contromisura
对称	duì chèn	simmetria
对付	duì fu	avere a che fare con
对抗	duì kàng	confronto
对立	duì lì	opposizione
对联	duì lián	distico
对应	duì yìng	corrispondere
对照	duì zhào	controllo
队伍	duì wu	squadra
顿时	dùn shí	ad un tratto
哆嗦	duō suo	tremito
多元化	duō yuán huà	diversificazione
堕落	duò luò	depravato
额外	é wài	aggiuntivo
恶心	ě xin	nausea
恶化	è huà	deterioramento
遏制	è zhì	contenere
恩怨	ēn yuàn	risentimento
而已	ér yǐ	questo è tutto
二氧化碳	èr yǎng huà tàn	diossido di carbonio
发布	fā bù	pubblicazione
发财	fā cái	diventare ricco
发呆	fā dāi	stordimento
发动	fā dòng	lanciare
发觉	fā jué	trova
发射	fā shè	emissione
发誓	fā shì	giurare
发行	fā xíng	rilasciato
发炎	fā yán	febbre
发扬	fā yáng	portare avanti
发育	fā yù	sviluppo
法人	fǎ rén	persona legale
番	fān	fan
凡是	fán shì	tutti
繁华	fán huá	vivace
繁忙	fán máng	occupato
繁体字	fán tǐ zì	cinese tradizionale
繁殖	fán zhí	razza
反驳	fǎn bó	confutare
反常	fǎn cháng	anormale
反感	fǎn gǎn	antipatia
反抗	fǎn kàng	rivolta
反馈	fǎn kuì	risposta
反面	fǎn miàn	negativo
反射	fǎn shè	riflessione
反思	fǎn sī	riflessione
反问	fǎn wèn	domanda retorica
反之	fǎn zhī	anzi
泛滥	fàn làn	alluvione
范畴	fàn chóu	categoria
贩卖	fàn mài	vendere
方位	fāng wèi	posizione
方言	fāng yán	dialetto
方圆	fāng yuán	fangyuan
方针	fāng zhēn	politica
防守	fáng shǒu	difensiva
防御	fáng yù	difesa
防止	fáng zhǐ	impedire
防治	fáng zhì	controllo
纺织	fǎng zhī	tessile
访问	fǎng wèn	accesso
放大	fàng dà	ingrandire
放射	fàng shè	radiazione
非法	fēi fǎ	illegale
飞禽走兽	fēi qín zǒu shòu	uccelli e animali
飞翔	fēi xiáng	volare
飞跃	fēi yuè	salto
肥沃	féi wò	fertile
诽谤	fěi bàng	diffamazione
废除	fèi chú	abolizione
废寝忘食	fèi qǐn wàng shí	insonne
废墟	fèi xū	rovine
沸腾	fèi téng	bollente
肺	fèi	polmone
分辨	fēn biàn	distinguere
分寸	fēn cun	misurare
分红	fēn hóng	dividendi
分解	fēn jiě	abbattersi
分裂	fēn liè	diviso
分泌	fēn mì	secrezione
分明	fēn míng	distinto
分歧	fēn qí	disaccordo
分散	fēn sàn	dispersione
吩咐	fēn fù	ordine
坟墓	fén mù	tomba
粉末	fěn mò	polvere
粉色	fěn sè	rosa
粉碎	fěn suì	distruggere
分量	fèn liàng	porzione
愤怒	fèn nù	rabbia
丰满	fēng mǎn	pieno
丰盛	fēng shèng	ricco
丰收	fēng shōu	raccolto eccezionale
封闭	fēng bì	chiuso
封建	fēng jiàn	feudale
封锁	fēng suǒ	blocco
锋利	fēng lì	acuto
风暴	fēng bào	tempesta
风度	fēng dù	comportamento
风光	fēng guāng	scenario
风气	fēng qì	atmosfera
风趣	fēng qù	divertente
风土人情	fēng tǔ rén qíng	usanze locali
风味	fēng wèi	gusto
逢	féng	ogni
奉献	fèng xiàn	dedizione
否决	fǒu jué	veto
夫妇	fū fù	coppia
夫人	fū ren	signora
敷衍	fū yǎn	superficiale
俘虏	fú lǔ	prigioniero
幅度	fú dù	ampiezza
服从	fú cóng	obbedire
服气	fú qì	convinto
福利	fú lì	benessere
福气	fú qi	benedizione
符号	fú hào	simbolo
辐射	fú shè	radiazione
俯视	fǔ shì	guarda giù
抚摸	fǔ mō	accarezzando
抚养	fǔ yǎng	aumentare
腐败	fǔ bài	corruzione
腐烂	fǔ làn	marcire
腐蚀	fǔ shí	corrosione
腐朽	fǔ xiǔ	decadimento
辅助	fǔ zhù	assist
副	fù	vice
复活	fù huó	risurrezione
复兴	fù xīng	rinascita
富裕	fù yù	ricco
腹泻	fù xiè	diarrea
覆盖	fù gài	copertina
负担	fù dān	fardello
赋予	fù yǔ	dare
附和	fù hè	andare avanti
附件	fù jiàn	allegato
附属	fù shǔ	allegato
改良	gǎi liáng	ottimizzare
盖章	gài zhāng	francobollo
钙	gài	calcio
尴尬	gān gà	imbarazzante
干旱	gān hàn	siccità
干扰	gān rǎo	interferenza
干涉	gān shè	metterci il becco
干预	gān yù	intervento
感慨	gǎn kǎi	sospiro
感染	gǎn rǎn	infezione
干劲	gàn jìn	entusiasmo
扛	gāng	trasportare
纲领	gāng lǐng	programma
岗位	gǎng wèi	inviare
港口	gǎng kǒu	porta
港湾	gǎng wān	porto
杠杆	gàng gǎn	leva
高超	gāo chāo	superbo
高潮	gāo cháo	climax
高峰	gāo fēng	picco
高明	gāo míng	intelligente
高尚	gāo shàng	nobile
高涨	gāo zhǎng	impennata
稿件	gǎo jiàn	manoscritto
告辞	gào cí	addio
告诫	gào jiè	ammonire
割	gē	tagliare
搁	gē	mettere
歌颂	gē sòng	lode
疙瘩	gē da	brufolo
鸽子	gē zi	piccione
格局	gé jú	modello
格式	gé shì	formato
隔阂	gé hé	divario
隔离	gé lí	isolamento
革命	gé mìng	rivoluzione
个体	gè tǐ	individuale
各抒己见	gè shū jǐ jiàn	esprimi le loro opinioni
根深蒂固	gēn shēn dì gù	radicato
根源	gēn yuán	fonte
跟前	gēn qián	di fronte a
跟随	gēn suí	seguire
跟踪	gēn zōng	traccia
更新	gēng xīn	aggiornare
更正	gēng zhèng	corretta
耕地	gēng dì	terra arabile
供不应求	gōng bù yìng qiú	in scarsità
供给	gōng jǐ	fornitura
公安局	gōng ān jú	ufficio di pubblica sicurezza
公道	gōng dào	giustizia
公告	gōng gào	annuncio
公关	gōng guān	pr
公民	gōng mín	cittadino
公然	gōng rán	apertamente
公认	gōng rèn	accettato
公式	gōng shì	formula
公务	gōng wù	affari ufficiali
公正	gōng zhèng	appena
公证	gōng zhèng	autenticazione notarile
功劳	gōng láo	credito
功效	gōng xiào	effetto
宫殿	gōng diàn	palazzo
工艺品	gōng yì pǐn	artigianato
恭敬	gōng jìng	rispettoso
攻击	gōng jī	attacco
攻克	gōng kè	catturare
巩固	gǒng gù	consolidare
共和国	gòng hé guó	repubblica
共计	gòng jì	totale
共鸣	gòng míng	risonanza
勾结	gōu jié	collude
钩子	gōu zi	gancio
构思	gòu sī	idea
姑且	gū qiě	provvisoriamente
孤独	gū dú	solitario
孤立	gū lì	isolato
辜负	gū fù	deludere
古董	gǔ dǒng	antico
古怪	gǔ guài	eccentrico
股东	gǔ dōng	azionista
股份	gǔ fèn	azioni
骨干	gǔ gàn	spina dorsale
鼓动	gǔ dòng	agitare
固然	gù rán	ovviamente
固体	gù tǐ	solido
固有	gù yǒu	inerente
固执	gù zhi	testardo
故乡	gù xiāng	casa
故障	gù zhàng	malfunzionamento
雇佣	gù yōng	assumere
顾虑	gù lv4	preoccupazione
顾问	gù wèn	consulente
拐杖	guǎi zhàng	stampella
关怀	guān huái	cura
关照	guān zhào	cura
官方	guān fāng	ufficiale
观光	guān guāng	fare un giro turistico
管辖	guǎn xiá	giurisdizione
惯例	guàn lì	convenzione
灌溉	guàn gài	irrigazione
罐	guàn	carro armato
贯彻	guàn chè	strumento
光彩	guāng cǎi	glorioso
光辉	guāng huī	glorioso
光芒	guāng máng	luce
光荣	guāng róng	gloria
广阔	guǎng kuò	ampio
归根到底	guī gēn dào dǐ	in ultima analisi
归还	guī huán	ritorno
规范	guī fàn	specifica
规格	guī gé	specifica
规划	guī huà	pianificazione
规章	guī zhāng	regolamento
轨道	guǐ dào	traccia
贵族	guì zú	nobile
跪	guì	inginocchiarsi
棍棒	gùn bàng	bastone
国防	guó fáng	difesa nazionale
国务院	guó wù yuàn	consiglio di stato
果断	guǒ duàn	decisivo
过度	guò dù	al di sopra di
过渡	guò dù	transizione
过奖	guò jiǎng	sopravvalutato
过滤	guò lv4	filtro
过失	guò shī	colpa
过问	guò wèn	intervenire
过瘾	guò yǐn	piacevole
过于	guò yú	pure
嗨	hāi	ciao
海拔	hǎi bá	altitudine
海滨	hǎi bīn	mare
含糊	hán hu	vago
含义	hán yì	senso
寒暄	hán xuān	saluto
罕见	hǎn jiàn	raro
捍卫	hàn wèi	difendere
航空	háng kōng	aviazione
航天	háng tiān	aerospaziale
航行	háng xíng	andare in barca
行列	háng liè	ranghi
毫米	háo mǐ	mm
毫无	háo wú	niente
豪迈	háo mài	eroico
号召	hào zhào	chiama
耗费	hào fèi	costo
呵	hē	ah
合并	hé bìng	unire
合成	hé chéng	sintesi
合伙	hé huǒ	collaborazione
合算	hé suàn	conveniente
和蔼	hé ǎi	genere
和解	hé jiě	riconciliazione
和睦	hé mù	armonia
和气	hé qi	gentilezza
和谐	hé xié	armonioso
嘿	hēi	hey
痕迹	hén jì	traccia
狠心	hěn xīn	senza cuore
恨不得	hèn bu dé	non vedo l'ora
哼	hēng	humph
横	héng	orizzontale
哄	hōng	coassiale
烘	hōng	infornare
轰动	hōng dòng	sensazione
宏观	hóng guān	macro
宏伟	hóng wěi	magnifico
洪水	hóng shuǐ	alluvione
喉咙	hóu lóng	gola
吼	hǒu	ruggito
候选	hòu xuǎn	candidato
后代	hòu dài	prole
后顾之忧	hòu gù zhī yōu	preoccupazioni
后勤	hòu qín	la logistica
呼唤	hū huàn	chiamata
呼啸	hū xiào	howl
呼吁	hū yù	chiamata
忽略	hū lvè	ignorare
湖泊	hú pō	lago
胡乱	hú luàn	casualmente
胡须	hú xū	barba
花瓣	huā bàn	petalo
花蕾	huā lěi	germoglio
华丽	huá lì	bellissima
华侨	huá qiáo	cinese d'oltremare
划分	huà fēn	dividere
化肥	huà féi	fertilizzante
化石	huà shí	fossile
化验	huà yàn	saggio
化妆	huà zhuāng	trucco
画蛇添足	huà shé tiān zú	superfluo
话筒	huà tǒng	microfono
欢乐	huān lè	gioia
环节	huán jié	link
还原	huán yuán	riduzione
缓和	huǎn hé	facilità
患者	huàn zhě	paziente
荒凉	huāng liáng	desolato
荒谬	huāng miù	assurdo
荒唐	huāng táng	assurdo
皇帝	huáng dì	imperatore
皇后	huáng hòu	regina
黄昏	huáng hūn	crepuscolo
恍然大悟	huǎng rán dà wù	improvvisamente realizzato
晃	huǎng	scuotere
挥霍	huī huò	splurge
辉煌	huī huáng	brillante
回报	huí bào	ritorno
回避	huí bì	evitare
回顾	huí gù	revisione
回收	huí shōu	riciclare
悔恨	huǐ hèn	rimorso
毁灭	huǐ miè	distruggere
会晤	huì wù	incontro
汇报	huì bào	rapporto
贿赂	huì lù	corrompere
昏迷	hūn mí	coma
荤	hūn	carne
浑身	hún shēn	ovunque
混合	hùn hé	mescolando
混乱	hùn luàn	confusione
混淆	hùn xiáo	confuso
混浊	hùn zhuó	torbido
活该	huó gāi	meritarlo
活力	huó lì	vitalità
火箭	huǒ jiàn	razzo
火焰	huǒ yàn	fiamma
火药	huǒ yào	polvere da sparo
货币	huò bì	moneta
基地	jī dì	base
基金	jī jīn	fondo
基因	jī yīn	gene
机动	jī dòng	manovra
机构	jī gòu	meccanismo
机灵	jī ling	intelligente
机密	jī mì	confidenziale
机械	jī xiè	meccanico
机遇	jī yù	opportunità
机智	jī zhì	spiritoso
激发	jī fā	eccitazione
激励	jī lì	eccitazione
激情	jī qíng	passione
讥笑	jī xiào	sneer
饥饿	jī è	fame
即便	jí biàn	anche se
即将	jí jiāng	prossimamente
及早	jí zǎo	presto
吉祥	jí xiáng	di buon auspicio
嫉妒	jí dù	geloso
急功近利	jí gōng jìn lì	rapido successo
急剧	jí jù	acuto
急切	jí qiè	desideroso
急于求成	jí yú qiú chéng	desideroso di successo
急躁	jí zào	impaziente
极端	jí duān	estremo
极限	jí xiàn	limite
疾病	jí bìng	patologia
籍贯	jí guàn	città natale
级别	jí bié	livello
集团	jí tuán	gruppo
给予	jǐ yǔ	dare
季军	jì jūn	terzo posto
季度	jì dù	trimestrale
寂静	jì jìng	silenzio
寄托	jì tuō	affidare
忌讳	jì huì	tabù
技巧	jì qiǎo	abilità
纪要	jì yào	sommario
继承	jì chéng	ereditare
计较	jì jiào	preoccupati
记性	jì xing	memoria
记载	jì zǎi	disco
迹象	jì xiàng	cartello
佳肴	jiā yáo	delicatezza
加工	jiā gōng	in lavorazione
加剧	jiā jù	intensificare
夹杂	jiā zá	inclusione
家常	jiā cháng	familiare
家伙	jiā huo	tipo
家属	jiā shǔ	membri della famiglia
家喻户晓	jiā yù hù xiǎo	ben noto
坚定	jiān dìng	fermo
坚固	jiān gù	ferma
坚韧	jiān rèn	difficile
坚实	jiān shí	solido
坚硬	jiān yìng	difficile
尖端	jiān duān	mancia
尖锐	jiān ruì	acuto
煎	jiān	fritto
监督	jiān dū	sorvegliare
监视	jiān shì	tenere sotto controllo
监狱	jiān yù	prigione
艰难	jiān nán	difficile
剪彩	jiǎn cǎi	taglia il nastro
拣	jiǎn	scegli
检讨	jiǎn tǎo	revisione
检验	jiǎn yàn	test
简化	jiǎn huà	semplificare
简陋	jiǎn lòu	greggio
简体字	jiǎn tǐ zì	cinese semplificato
简要	jiǎn yào	breve
健全	jiàn quán	suono
剑	jiàn	spada
溅	jiàn	splash
舰艇	jiàn tǐng	nave
见多识广	jiàn duō shí guǎng	esperto
见解	jiàn jiě	opinione
见闻	jiàn wén	conoscenza
见义勇为	jiàn yì yǒng wéi	giustificare
践踏	jiàn tà	calpestare
鉴别	jiàn bié	identificare
鉴定	jiàn dìng	identificazione
鉴于	jiàn yú	dato
间谍	jiàn dié	spiare
间隔	jiàn gé	intervallo
间接	jiàn jiē	indiretta
僵硬	jiāng yìng	rigido
将军	jiāng jūn	generale
将近	jiāng jìn	quasi
将就	jiāng jiù	sarà
奖励	jiǎng lì	ricompensa
奖赏	jiǎng shǎng	ricompensa
桨	jiǎng	pagaia
降临	jiàng lín	venire
交叉	jiāo chā	attraversare
交代	jiāo dài	spiegare
交涉	jiāo shè	negoziazione
交易	jiāo yì	transazione
娇气	jiāo qì	schizzinoso
焦点	jiāo diǎn	messa a fuoco
焦急	jiāo jí	ansioso
侥幸	jiǎo xìng	fortunato
搅拌	jiǎo bàn	agitare
缴纳	jiǎo nà	pagare
角落	jiǎo luò	angolo
教养	jiào yǎng	educazione
较量	jiào liàng	concorso
接连	jiē lián	raccogliere
揭露	jiē lù	esporre
皆	jiē	tutti
阶层	jiē céng	classe
截止	jié zhǐ	tagliato fuori
截至	jié zhì	come di
杰出	jié chū	eccezionale
竭尽全力	jié jìn quán lì	fai del tuo meglio
结晶	jié jīng	cristallizzazione
结局	jié jú	finire
结算	jié suàn	insediamento
节制	jié zhì	controllo
节奏	jié zòu	ritmo
解除	jiě chú	respingere
解放	jiě fàng	liberazione
解雇	jiě gù	licenziamento
解剖	jiě pōu	anatomia
解散	jiě sàn	sciogliere
解体	jiě tǐ	disintegrazione
借鉴	jiè jiàn	prestito
借助	jiè zhù	con l'aiuto di
戒备	jiè bèi	mettere in guardia
界限	jiè xiàn	limite
津津有味	jīn jīn yǒu wèi	con gusto
金融	jīn róng	finanziario
紧迫	jǐn pò	urgente
锦上添花	jǐn shàng tiān huā	ciliegina sulla torta
晋升	jìn shēng	promozione
浸泡	jìn pào	bagnare
近来	jìn lái	recentemente
进而	jìn ér	e poi
进攻	jìn gōng	attacco
进化	jìn huà	evoluzione
进展	jìn zhǎn	progresso
兢兢业业	jīng jīng yè yè	coscienzioso
惊动	jīng dòng	disturbare
惊奇	jīng qí	sorpresa
惊讶	jīng yà	sorpreso
精打细算	jīng dǎ xì suàn	pianifica attentamente
精华	jīng huá	essenza
精简	jīng jiǎn	razionalizzare
精密	jīng mì	precisione
精确	jīng què	accurato
精通	jīng tōng	esperto
精心	jīng xīn	elaborare
精益求精	jīng yì qiú jīng	continua a migliorare
精致	jīng zhì	squisito
经费	jīng fèi	finanziamento
经纬	jīng wěi	latitudine e longitudine
茎	jīng	stelo
井	jǐng	bene
警告	jǐng gào	avvertimento
警惕	jǐng tì	mettere in guardia
颈椎	jǐng zhuī	colonna cervicale
境界	jìng jiè	regno
敬礼	jìng lǐ	saluto
敬业	jìng yè	dedicato
竞赛	jìng sài	concorrenza
竞选	jìng xuǎn	campagna
镜头	jìng tóu	lens
纠纷	jiū fēn	disputa
纠正	jiū zhèng	corretta
酒精	jiǔ jīng	alcol
就近	jiù jìn	nelle vicinanze
就业	jiù yè	occupazione
就职	jiù zhí	inaugurazione
救济	jiù jì	sollievo
居民	jū mín	residenti
居住	jū zhù	vivere
拘留	jū liú	detenzione
拘束	jū shù	contenzione
鞠躬	jū gōng	arco
局部	jú bù	parziale
局面	jú miàn	situazione
局势	jú shì	situazione
局限	jú xiàn	limitazioni
举动	jǔ dòng	mossa
举世瞩目	jǔ shì zhǔ mù	attira l'attenzione mondiale
举足轻重	jǔ zú qīng zhòng	fondamentale
咀嚼	jǔ jué	masticare
沮丧	jǔ sàng	frustrato
剧本	jù běn	script
剧烈	jù liè	acuto
据悉	jù xī	è stato riferito che
聚精会神	jù jīng huì shén	concentrati
卷	juǎn	volume
倔强	jué jiàng	testardo
决策	jué cè	il processo decisionale
绝望	jué wàng	disperazione
觉悟	jué wù	coscienza
觉醒	jué xǐng	risveglio
军队	jūn duì	esercito
君子	jūn zǐ	signore
卡通	kǎ tōng	cartoni animati
开采	kāi cǎi	estrazione
开除	kāi chú	espulso
开阔	kāi kuò	aperto
开朗	kāi lǎng	allegro
开明	kāi míng	illuminato
开辟	kāi pì	aprire
开拓	kāi tuò	aprire
开展	kāi zhǎn	sviluppare
开支	kāi zhī	spesa
刊登	kān dēng	pubblicare
刊物	kān wù	pubblicazione
勘探	kān tàn	esplorazione
侃侃而谈	kǎn kǎn ér tán	parla liberamente
砍伐	kǎn fá	abbattimento
看待	kàn dài	guarda a
慷慨	kāng kǎi	generoso
抗议	kàng yì	protesta
考察	kǎo chá	sondaggio
考古	kǎo gǔ	archeologia
考核	kǎo hé	valutazione
考验	kǎo yàn	test
靠拢	kào lǒng	avvicinarsi
磕	kē	bussare
科目	kē mù	soggetto
可观	kě guān	considerevole
可口	kě kǒu	gustoso
可恶	kě wù	odioso
可行	kě xíng	fattibile
渴望	kě wàng	desiderio
克制	kè zhì	moderazione
刻不容缓	kè bù róng huǎn	non c'è tempo per ritardare
客户	kè hù	cliente
课题	kè tí	soggetto
啃	kěn	mordere
恳切	kěn qiè	sincero
坑	kēng	fossa
空洞	kōng dòng	cavo
空前绝后	kōng qián jué hòu	senza precedenti
空想	kōng xiǎng	fantasia
空虚	kōng xū	vuoto
孔	kǒng	buco
恐怖	kǒng bù	terrore
恐吓	kǒng hè	intimidire
恐惧	kǒng jù	paura
空白	kòng bái	vuoto
空隙	kòng xì	gap
口气	kǒu qì	tono
口腔	kǒu qiāng	cavità orale
口头	kǒu tóu	orale
口音	kǒu yīn	accento
扣	kòu	fibbia
哭泣	kū qì	piangere
枯萎	kū wěi	appassito
枯燥	kū zào	noioso
苦尽甘来	kǔ jìn gān lái	amarezza
苦涩	kǔ sè	amaro
挎	kuà	trasportare
跨	kuà	span
快活	kuài huo	contento
宽敞	kuān chang	spazioso
宽容	kuān róng	tollerante
款待	kuǎn dài	ospitalità
款式	kuǎn shì	stile
筐	kuāng	cestino
况且	kuàng qiě	oltretutto
旷课	kuàng kè	assenteismo
框架	kuàng jià	telaio
矿产	kuàng chǎn	minerale
亏待	kuī dài	tratta male
亏损	kuī sǔn	perdita
捆绑	kǔn bǎng	legato
扩充	kuò chōng	espansione
扩散	kuò sàn	diffusione
扩张	kuò zhāng	espansione
啦	lā	la
喇叭	lǎ ba	altoparlante
蜡烛	là zhú	candela
来历	lái lì	origine
来源	lái yuán	fonte
栏目	lán mù	colonna
懒惰	lǎn duò	pigro
狼狈	láng bèi	imbarazzato
狼吞虎咽	láng tūn hǔ yàn	lupo
捞	lāo	pesce
唠叨	láo dao	fastidioso
牢固	láo gù	fermo
牢骚	láo sāo	brontolare
乐趣	lè qù	piacere
乐意	lè yì	disposto
雷达	léi dá	radar
类似	lèi sì	simile
冷酷	lěng kù	crudele
冷落	lěng luò	lasciato fuori
冷却	lěng què	calmati
愣	lèng	congelato
黎明	lí míng	alba
理睬	lǐ cǎi	prestare attenzione a
理所当然	lǐ suǒ dāng rán	ovviamente
理直气壮	lǐ zhí qì zhuàng	semplice
理智	lǐ zhì	motivo
礼节	lǐ jié	etichetta
礼尚往来	lǐ shàng wǎng lái	reciprocità
里程碑	lǐ chéng bēi	pietra miliare
例外	lì wài	eccezione
利害	lì hài	palo
力求	lì qiú	sforzarsi
力所能及	lì suǒ néng jí	in nostro potere
力争	lì zhēng	sforzati
历代	lì dài	storia
历来	lì lái	sempre
立场	lì chǎng	posizione
立方	lì fāng	cubo
立交桥	lì jiāo qiáo	cavalcavia
立体	lì tǐ	tridimensionale
立足	lì zú	stai in piedi
粒	lì	grano
廉洁	lián jié	pulito
联欢	lián huān	raduno
联络	lián luò	connessione
联盟	lián méng	alleanza
联想	lián xiǎng	lenovo
连年	lián nián	anno dopo anno
连锁	lián suǒ	catena
连同	lián tóng	insieme a
良心	liáng xīn	coscienza
晾	liàng	aria
谅解	liàng jiě	comprensione
辽阔	liáo kuò	vasto
列举	liè jǔ	enumerare
临床	lín chuáng	clinico
淋	lín	doccia
吝啬	lìn sè	avaro
伶俐	líng lì	inteligente
凌晨	líng chén	mattina presto
灵感	líng gǎn	ispirazione
灵魂	líng hún	anima
灵敏	líng mǐn	sensibile
零星	líng xīng	sporadico
领会	lǐng huì	capire
领事馆	lǐng shì guǎn	consolato
领土	lǐng tǔ	territorio
领悟	lǐng wù	comprendere
领先	lǐng xiān	condurre
领袖	lǐng xiù	capo
溜	liū	scivolare
流浪	liú làng	vagare
流露	liú lù	svelare
流氓	liú máng	canaglia
流通	liú tōng	circolazione
留恋	liú liàn	nostalgia
留念	liú niàn	souvenir
留神	liú shén	attento
聋哑	lóng yǎ	sordo e muto
隆重	lóng zhòng	mille dollari
垄断	lǒng duàn	monopolio
笼罩	lǒng zhào	avvolta
搂	lǒu	abbraccio
炉灶	lú zào	stufa
轮船	lún chuán	piroscafo
轮廓	lún kuò	contorno
轮胎	lún tāi	pneumatici
论坛	lùn tán	forum
论证	lùn zhèng	discussione
啰唆	luō suo	fastidioso
络绎不绝	luò yì bù jué	flusso infinito
落成	luò chéng	completato
落实	luò shí	strumento
屡次	lv3 cì	ripetutamente
履行	lv3 xíng	adempiere
掠夺	lvè duó	saccheggiare
嘛	ma	bene
麻痹	má bì	paralisi
麻木	má mù	intorpidimento
麻醉	má zuì	anestesia
码头	mǎ tóu	molo
蚂蚁	mǎ yǐ	formica
埋伏	mái fú	imboscata
埋没	mái mò	sepolto
埋葬	mái zàng	seppellire
脉搏	mài bó	impulso
迈	mài	passo
埋怨	mán yuàn	lamentarsi
慢性	màn xìng	cronico
漫长	màn cháng	lungo
漫画	màn huà	i fumetti
蔓延	màn yán	diffusione
忙碌	máng lù	occupato
盲目	máng mù	ciecamente
茫茫	máng máng	vasto
茫然	máng rán	in perdita
冒充	mào chōng	impersonare
冒犯	mào fàn	offendere
茂盛	mào shèng	fiorire
媒介	méi jiè	medio
枚	méi	pezzi
美观	měi guān	bellissimo
美满	měi mǎn	contento
美妙	měi miào	meraviglioso
萌芽	méng yá	germoglio
猛烈	měng liè	violento
眯	mī	strabismo
弥补	mí bǔ	trucco
弥漫	mí màn	diffondere
谜语	mí yǔ	enigma
迷惑	mí huo	confuso
迷人	mí rén	affascinante
迷信	mí xìn	superstizione
密度	mì dù	densità
密封	mì fēng	foca
棉花	mián hua	cotone
免得	miǎn de	per timore
免疫	miǎn yì	immunità
勉励	miǎn lì	incoraggiare
勉强	miǎn qiǎng	con riluttanza
面貌	miàn mào	viso
面子	miàn zi	viso
描绘	miáo huì	raffigura
瞄准	miáo zhǔn	scopo
渺小	miǎo xiǎo	piccolo
藐视	miǎo shì	disprezzo
灭亡	miè wáng	perire
蔑视	miè shì	disprezzo
民间	mín jiān	folk
民主	mín zhǔ	democrazia
敏捷	mǐn jié	agile
敏锐	mǐn ruì	acuto
名次	míng cì	classifica
名额	míng é	quota
名副其实	míng fù qí shí	degno di questo nome
名誉	míng yù	reputazione
明明	míng míng	ovviamente
明智	míng zhì	saggio
命名	mìng míng	nome
摸索	mō suo	a tentoni
摩擦	mó cā	attrito
模范	mó fàn	modello
模式	mó shì	modalità
模型	mó xíng	modello
磨合	mó hé	correre in
膜	mó	membrana
魔鬼	mó guǐ	diavolo
魔术	mó shù	magia
抹杀	mǒ shā	obliterate
墨水儿	mò shuǐ r	inchiostro
莫名其妙	mò míng qí miào	sconcertante
默默	mò mò	silenziosamente
谋求	móu qiú	cercare
模样	mú yàng	aspetto
母语	mǔ yǔ	madrelingua
沐浴	mù yù	fare il bagno
目睹	mù dǔ	testimone
目光	mù guāng	guarda
拿手	ná shǒu	bene
纳闷儿	nà mèn r	mi chiedo
耐用	nài yòng	durevole
南辕北辙	nán yuán běi zhé	divergente
难得	nán dé	raro
难堪	nán kān	imbarazzato
难能可贵	nán néng kě guì	lodevole
恼火	nǎo huǒ	infastidito
内涵	nèi hán	connotazione
内幕	nèi mù	dentro la storia
内在	nèi zài	interno
能量	néng liàng	energia
拟定	nǐ dìng	redigere
逆行	nì xíng	retrogrado
年度	nián dù	anno
捏	niē	pizzico
凝固	níng gù	solidificazione
凝聚	níng jù	coesione
凝视	níng shì	sguardo
拧	níng	vite
宁肯	nìng kěn	piuttosto
宁愿	nìng yuàn	preferirei
扭转	niǔ zhuǎn	twist
纽扣儿	niǔ kòu r	bottoni
农历	nóng lì	calendario lunare
浓厚	nóng hòu	forte
奴隶	nú lì	schiavo
挪	nuó	mossa
虐待	nvè dài	abuso
哦	ò	oh
殴打	ōu dǎ	battere
偶像	ǒu xiàng	idolo
呕吐	ǒu tù	vomito
趴	pā	menzogna
徘徊	pái huái	vagare
排斥	pái chì	respingere
排除	pái chú	escludere
排放	pái fàng	emissione
排练	pái liàn	provare
派别	pài bié	fazione
派遣	pài qiǎn	spedire
攀登	pān dēng	la scalata
盘旋	pán xuán	girando
判决	pàn jué	giudizio
畔	pàn	banca
庞大	páng dà	enorme
抛弃	pāo qì	abbandono
泡沫	pào mò	schiuma
培育	péi yù	coltiva
配备	pèi bèi	dotato
配偶	pèi ǒu	sposa
配套	pèi tào	corrispondenza
盆地	pén dì	bacino
烹饪	pēng rèn	cucinando
捧	pěng	aspetta
劈	pī	hack
批发	pī fā	vendita all'ingrosso
批判	pī pàn	critica
疲惫	pí bèi	esausto
疲倦	pí juàn	stanco
皮革	pí gé	pelle
屁股	pì gu	culo
譬如	pì rú	per esempio
偏差	piān chā	deviazione
偏见	piān jiàn	pregiudizio
偏僻	piān pì	a distanza
偏偏	piān piān	anzi
片断	piàn duàn	frammento
片刻	piàn kè	momento
漂浮	piāo fú	galleggiante
飘扬	piāo yáng	flutter
撇	piē	scrematura
拼搏	pīn bó	lavoro duro
拼命	pīn mìng	disperatamente
贫乏	pín fá	povero
贫困	pín kùn	povero
频繁	pín fán	frequentemente
频率	pín lv4	frequenza
品尝	pǐn cháng	gusto
品德	pǐn dé	carattere
品质	pǐn zhì	qualità
品种	pǐn zhǒng	varietà
屏幕	píng mù	schermo
屏障	píng zhàng	barriera
平凡	píng fán	ordinario
平面	píng miàn	piatto
平坦	píng tǎn	piatto
平行	píng xíng	parallelo
平庸	píng yōng	mediocre
平原	píng yuán	pianura
评估	píng gū	valutazione
评论	píng lùn	commento
坡	pō	pendenza
泼	pō	splash
颇	pō	abbastanza
破例	pò lì	fai un'eccezione
迫不及待	pò bù jí dài	non vedo l'ora
迫害	pò hài	persecuzione
魄力	pò lì	coraggio
扑	pū	svolazzare
铺	pū	negozio
普及	pǔ jí	universale
朴实	pǔ shí	semplice
朴素	pǔ sù	semplice
瀑布	pù bù	cascata
凄凉	qī liáng	desolato
期望	qī wàng	aspettarsi
期限	qī xiàn	il termine
欺负	qī fu	prepotente
欺骗	qī piàn	ingannare
奇妙	qí miào	meraviglioso
旗袍	qí páo	cheongsam
旗帜	qí zhì	banner
歧视	qí shì	discriminazione
齐全	qí quán	completare
齐心协力	qí xīn xié lì	lavorare insieme
乞丐	qǐ gài	mendicante
企图	qǐ tú	tentativo
启程	qǐ chéng	partire
启蒙	qǐ méng	illuminismo
启事	qǐ shì	avviso
启示	qǐ shì	illuminismo
岂有此理	qǐ yǒu cǐ lǐ	irragionevole
起草	qǐ cǎo	redazione
起初	qǐ chū	all'inizio
起伏	qǐ fú	alti e bassi
起哄	qǐ hòng	fischi
起码	qǐ mǎ	almeno
起源	qǐ yuán	origine
器材	qì cái	attrezzature
器官	qì guān	organo
气概	qì gài	spirito
气功	qì gōng	qigong
气魄	qì pò	grassetto
气色	qì sè	carnagione
气势	qì shì	quantità di moto
气味	qì wèi	odore
气象	qì xiàng	meteorologico
气压	qì yā	pressione dell'aria
气质	qì zhí	temperamento
迄今为止	qì jīn wéi zhǐ	finora
掐	qiā	pizzico
恰当	qià dàng	adeguata
恰到好处	qià dào hǎo chù	giusto
恰巧	qià qiǎo	coincidentalmente
洽谈	qià tán	negoziare
千方百计	qiān fāng bǎi jì	fai tutto il possibile
牵	qiān	condurre
牵扯	qiān chě	coinvolgere
牵制	qiān zhì	contenere
签署	qiān shǔ	cartello
谦逊	qiān xùn	umile
迁就	qiān jiù	ospitare
迁徙	qiān xǐ	migrazione
前景	qián jǐng	prospettiva
前提	qián tí	premessa
潜力	qián lì	potenziale
潜水	qián shuǐ	immersioni
潜移默化	qián yí mò huà	impercettibilmente
谴责	qiǎn zé	condannare
抢劫	qiāng jié	rapina
强制	qiáng zhì	obbligatorio
强迫	qiǎng pò	vigore
抢救	qiǎng jiù	salvare
桥梁	qiáo liáng	ponte
窍门	qiào mén	trucco
翘	qiào	alice
切实	qiè shí	pratico
锲而不舍	qiè ér bù shě	perseveranza
亲密	qīn mì	vicino
亲热	qīn rè	affettuoso
侵犯	qīn fàn	violare
侵略	qīn lvè	aggressione
钦佩	qīn pèi	ammirazione
勤俭	qín jiǎn	laborioso
勤劳	qín láo	industrioso
倾听	qīng tīng	ascolta
倾向	qīng xiàng	tendenza
倾斜	qīng xié	inclinazione
清澈	qīng chè	chiaro
清晨	qīng chén	mattina presto
清除	qīng chú	chiaro
清洁	qīng jié	pulito
清理	qīng lǐ	pulire
清晰	qīng xī	chiaro
清醒	qīng xǐng	ben sveglio
清真	qīng zhēn	musulmano
情报	qíng bào	intelligenza
情节	qíng jié	tracciare
情理	qíng lǐ	senso
情形	qíng xíng	situazione
晴朗	qíng lǎng	soleggiato
请柬	qǐng jiǎn	invito
请教	qǐng jiào	consultare
请示	qǐng shì	chiedi istruzioni
请帖	qǐng tiě	invito
丘陵	qiū líng	colline
区分	qū fēn	distinguere
区域	qū yù	la zona
屈服	qū fú	dare la precedenza
曲折	qū zhé	tortuoso
驱逐	qū zhú	espellere
渠道	qú dào	canale
取缔	qǔ dì	bandire
曲子	qǔ zi	canzone
趣味	qù wèi	gusto
圈套	quān tào	trappola
全局	quán jú	globale
全力以赴	quán lì yǐ fù	andare tutti fuori
拳头	quán tou	cazzotto
权衡	quán héng	scambio
权威	quán wēi	autorità
犬	quǎn	cane
缺口	quē kǒu	divario
缺席	quē xí	assenza
缺陷	quē xiàn	difetto
瘸	qué	noioso
确保	què bǎo	assicurarsi
确立	què lì	stabilire
确切	què qiè	esatto
确信	què xìn	convinto
群众	qún zhòng	le masse
染	rǎn	colorante
嚷	rǎng	grido
让步	ràng bù	concessione
饶恕	ráo shù	perdonare
扰乱	rǎo luàn	disturbare
惹祸	rě huò	disastro giudiziario
热泪盈眶	rè lèi yíng kuàng	lacrime agli occhi
热门	rè mén	popolare
人道	rén dào	umano
人格	rén gé	personalità
人工	rén gōng	artificiale
人家	rén jia	persone
人间	rén jiān	mondo
人士	rén shì	persona
人为	rén wéi	artificiale
人性	rén xìng	natura umana
人质	rén zhì	ostaggio
仁慈	rén cí	gentilezza
忍耐	rěn nài	pazienza
忍受	rěn shòu	sopportare
任命	rèn mìng	appuntamento
任性	rèn xìng	capriccioso
任意	rèn yì	arbitrario
任重道远	rèn zhòng dào yuǎn	una lunga strada da percorrere
认定	rèn dìng	riconoscere
认可	rèn kě	riconosciuto
仍旧	réng jiù	ancora
日新月异	rì xīn yuè yì	cambiando ogni giorno che passa
日益	rì yì	sempre più
容貌	róng mào	aspetto
容纳	róng nà	ospitare
容器	róng qì	contenitore
容忍	róng rěn	tollerare
溶解	róng jiě	sciogliere
荣幸	róng xìng	con piacere
荣誉	róng yù	onore
融化	róng huà	sciogliersi
融洽	róng qià	rapporto
揉	róu	strofinare
柔和	róu hé	morbido
儒家	rú jiā	confucianesimo
弱点	ruò diǎn	debolezza
若干	ruò gān	parecchi
撒谎	sā huǎng	menzogna
散文	sǎn wén	prosa
散布	sàn bù	diffusione
散发	sàn fā	distribuire
丧失	sàng shī	perdere
骚扰	sāo rǎo	molestare
嫂子	sǎo zi	cognata
刹车	shā chē	freno
啥	shá	che cosa
筛选	shāi xuǎn	filtro
山脉	shān mài	montagne
闪烁	shǎn shuò	lampeggiante
擅长	shàn cháng	bravo a
擅自	shàn zì	non autorizzato
伤脑筋	shāng nǎo jīn	fastidioso
商标	shāng biāo	marchio
上级	shàng jí	superiore
上进	shàng jìn	motivare
上任	shàng rèn	entrare in carica
上瘾	shàng yǐn	dipendente
上游	shàng yóu	a monte
尚且	shàng qiě	ancora
捎	shāo	portare con sé
梢	shāo	mancia
哨	shào	inviare
奢侈	shē chǐ	lusso
舌头	shé tou	lingua
摄氏度	shè shì dù	centigrado
涉及	shè jí	coinvolti
社区	shè qū	comunità
设立	shè lì	impostare
设想	shè xiǎng	immaginare
设置	shè zhì	impostare
呻吟	shēn yín	gemito
深奥	shēn ào	profondo
深沉	shēn chén	in profondità
深情厚谊	shēn qíng hòu yì	profonda amicizia
申报	shēn bào	dichiarare
绅士	shēn shì	signore
神经	shén jīng	nervo
神奇	shén qí	magico
神气	shén qì	aria
神圣	shén shèng	sacro
神态	shén tài	comportamento
神仙	shén xiān	immortale
审查	shěn chá	revisione
审理	shěn lǐ	prova
审美	shěn měi	estetico
审判	shěn pàn	prova
慎重	shèn zhòng	attento
渗透	shèn tòu	penetrazione
声明	shēng míng	dichiarazione
声势	shēng shì	quantità di moto
声誉	shēng yù	reputazione
牲畜	shēng chù	bestiame
生存	shēng cún	sopravvivere
生机	shēng jī	vitalità
生理	shēng lǐ	fisiologico
生疏	shēng shū	arrugginito
生态	shēng tài	ecologia
生物	shēng wù	biologico
生效	shēng xiào	prende effetto
生肖	shēng xiào	zodiaco
生锈	shēng xiù	ruggine
生育	shēng yù	fertilità
省会	shěng huì	capoluogo di provincia
盛产	shèng chǎn	ricco
盛开	shèng kāi	fioritura
盛情	shèng qíng	ospitalità
盛行	shèng xíng	prevalere
胜负	shèng fù	vincere o perdere
失事	shī shì	relitto
失误	shī wù	sbaglio
失踪	shī zōng	mancante
尸体	shī tǐ	corpo morto
师范	shī fàn	insegnante
施加	shī jiā	imporre
施展	shī zhǎn	schermo
十足	shí zú	pieno
实惠	shí huì	conveniente
实力	shí lì	forza
实施	shí shī	strumento
实事求是	shí shì qiú shì	cerca la verità dai fatti
实行	shí xíng	strumento
实质	shí zhì	sostanza
拾	shí	raccogliere
时常	shí cháng	spesso
时而	shí ér	a volte
时光	shí guāng	tempo
时机	shí jī	opportunità
时事	shí shì	attualità
石油	shí yóu	olio
识别	shí bié	identificare
使命	shǐ mìng	missione
世代	shì dài	generazioni
事故	shì gù	incidente
事迹	shì jì	atti
事件	shì jiàn	evento
事态	shì tài	situazione
事务	shì wù	affari
事项	shì xiàng	importa
事业	shì yè	causa
势必	shì bì	legato a
势力	shì li	energia
是非	shì fēi	giusto o sbagliato
示范	shì fàn	dimostrazione
示威	shì wēi	dimostrazione
示意	shì yì	segnale
视力	shì lì	visione
视频	shì pín	video
视线	shì xiàn	vista
视野	shì yě	visione
试图	shì tú	tentativo
试验	shì yàn	test
适宜	shì yí	adatto
逝世	shì shì	passare
释放	shì fàng	liberato
收藏	shōu cáng	preferiti
收缩	shōu suō	ridursi
收益	shōu yì	reddito
收音机	shōu yīn jī	radio
守护	shǒu hù	guardia
手法	shǒu fǎ	tecnica
手势	shǒu shì	gesto
手艺	shǒu yì	mestiere
首饰	shǒu shì	gioielleria
首要	shǒu yào	primario
受罪	shòu zuì	soffrire
授予	shòu yǔ	concedere
书法	shū fǎ	calligrafia
书记	shū ji	segretario
书籍	shū jí	libri
书面	shū miàn	scritto
疏忽	shū hu	negligenza
疏远	shū yuǎn	alienare
舒畅	shū chàng	confortevole
数额	shù é	quantità
束	shù	bundle
束缚	shù fù	bondage
树立	shù lì	impostare
竖	shù	verticale
耍	shuǎ	giocare
衰老	shuāi lǎo	senescenza
衰退	shuāi tuì	declino
率领	shuài lǐng	condurre
涮火锅	shuàn huǒ guō	shabu shabu
双胞胎	shuāng bāo tāi	gemello
爽快	shuǎng kuài	prontamente
水利	shuǐ lì	tutela dell'acqua
水龙头	shuǐ lóng tóu	rubinetto
水泥	shuǐ ní	cemento
瞬间	shùn jiān	momento
司法	sī fǎ	giudiziario
司令	sī lìng	comandante
思念	sī niàn	perdere
思索	sī suǒ	pensiero
思维	sī wéi	pensiero
斯文	sī wen	gentile
私自	sī zì	privatamente
死亡	sǐ wáng	morte
四肢	sì zhī	arti
寺庙	sì miào	tempio
肆无忌惮	sì wú jì dàn	senza scrupoli
饲养	sì yǎng	allevamento
耸	sǒng	torreggiante
艘	sōu	nave
苏醒	sū xǐng	svegliarsi
俗话	sú huà	gergo
塑造	sù zào	forma
素食	sù shí	cibo vegetariano
素质	sù zhì	qualità
诉讼	sù sòng	contenzioso
算数	suàn shù	contare
随即	suí jí	subito
随意	suí yì	casuale
岁月	suì yuè	anni
隧道	suì dào	tunnel
损坏	sǔn huài	danno
索取	suǒ qǔ	richiesta
索性	suǒ xìng	semplicemente
塌	tā	crollo
踏实	tā shi	costante
塔	tǎ	torre
台风	tái fēng	tifone
太空	tài kōng	spazio
泰斗	tài dǒu	decano
摊	tān	stalla
瘫痪	tān huàn	paralisi
贪婪	tān lán	avido
贪污	tān wū	corruzione
弹性	tán xìng	elasticità
坦白	tǎn bái	franco
叹气	tàn qì	sospiro
探测	tàn cè	rileva
探索	tàn suǒ	esplorare
探讨	tàn tǎo	esplorare
探望	tàn wàng	visita
倘若	tǎng ruò	se
掏	tāo	scavare
滔滔不绝	tāo tāo bù jué	parla all'infinito
淘汰	táo tài	eliminato
陶瓷	táo cí	ceramica
陶醉	táo zuì	divertirsi
讨好	tǎo hǎo	per favore
特长	tè cháng	specialità
特定	tè dìng	specifica
特意	tè yì	appositamente
提拔	tí bá	promosso
提炼	tí liàn	raffinazione
提示	tí shì	richiesta
提议	tí yì	proposta
题材	tí cái	tema
体裁	tǐ cái	genere
体积	tǐ jī	volume
体谅	tǐ liàng	premuroso
体面	tǐ miàn	decente
体系	tǐ xì	sistema
天才	tiān cái	genio
天赋	tiān fù	talento
天伦之乐	tiān lún zhī lè	divertimento in famiglia
天然气	tiān rán qì	gas naturale
天生	tiān shēng	nato
天堂	tiān táng	paradiso
天文	tiān wén	astronomico
田径	tián jìng	atletica leggera
田野	tián yě	campo
舔	tiǎn	leccare
挑剔	tiāo ti	schizzinoso
条款	tiáo kuǎn	termini
条理	tiáo lǐ	organizzato
条约	tiáo yuē	trattato
调和	tiáo hé	riconciliare
调剂	tiáo jì	regolare
调节	tiáo jié	regolare
调解	tiáo jiě	mediazione
调料	tiáo liào	stagionatura
挑拨	tiǎo bō	spareggio
挑衅	tiǎo xìn	provocatorio
跳跃	tiào yuè	saltare
亭子	tíng zi	padiglione
停泊	tíng bó	parcheggiato
停顿	tíng dùn	pausa
停滞	tíng zhì	stagnante
挺拔	tǐng bá	alto e dritto
通货膨胀	tōng huò péng zhàng	inflazione
通缉	tōng jī	ricercato
通俗	tōng sú	popolare
通讯	tōng xùn	comunicazione
通用	tōng yòng	universale
同胞	tóng bāo	fratello
同志	tóng zhì	gay
童话	tóng huà	fiaba
铜	tóng	rame
统筹兼顾	tǒng chóu jiān gù	pianificazione generale
统计	tǒng jì	statistiche
统统	tǒng tǒng	tutti
统治	tǒng zhì	regola
投机	tóu jī	speculazione
投票	tóu piào	votazione
投诉	tóu sù	denuncia
投降	tóu xiáng	resa
投掷	tóu zhì	gettare
透露	tòu lù	divulgare
秃	tū	calvo
突破	tū pò	sfondamento
图案	tú àn	modello
徒弟	tú dì	apprendista
涂抹	tú mǒ	spalmare
途径	tú jìng	modo
土壤	tǔ rǎng	suolo
团结	tuán jié	unità
团体	tuán tǐ	gruppo
团圆	tuán yuán	riunione
推测	tuī cè	ipotizzare
推翻	tuī fān	rovesciare
推理	tuī lǐ	ragionamento
推论	tuī lùn	inferenza
推销	tuī xiāo	vendere
吞吞吐吐	tūn tūn tǔ tǔ	esitante
托运	tuō yùn	spedizione
拖延	tuō yán	indugio
脱离	tuō lí	staccarsi
妥当	tuǒ dang	adeguata
妥善	tuǒ shàn	corretto
妥协	tuǒ xié	compromesso
椭圆	tuǒ yuán	ovale
唾弃	tuò qì	messo da parte
哇	wa	wow
挖掘	wā jué	scavare
娃娃	wá wa	bambola
瓦解	wǎ jiě	crollo
歪曲	wāi qū	distorcere
外表	wài biǎo	aspetto
外行	wài háng	laico
外界	wài jiè	mondo esterno
外向	wài xiàng	estroverso
丸	wán	pillola
完备	wán bèi	completare
完毕	wán bì	completare
玩弄	wán nòng	giocare
玩意儿	wán yì r	cosa
顽固	wán gù	testardo
顽强	wán qiáng	tenace
惋惜	wǎn xī	rimpiangere
挽回	wǎn huí	riscattare
挽救	wǎn jiù	salva
万分	wàn fēn	estremamente
往常	wǎng cháng	come di solito
往事	wǎng shì	passato
妄想	wàng xiǎng	delusione
危机	wēi jī	crisi
威风	wēi fēng	prestigio
威力	wēi lì	energia
威望	wēi wàng	prestigio
威信	wēi xìn	prestigio
微不足道	wēi bù zú dào	trascurabile
微观	wēi guān	micro
为难	wéi nán	imbarazzato
为期	wéi qī	durata
唯独	wéi dú	solo
维持	wéi chí	mantenere
维护	wéi hù	mantenere
维生素	wéi shēng sù	vitamine
违背	wéi bèi	andare contro
伪造	wěi zào	falsificazione
委托	wěi tuō	commissione
委员	wěi yuán	membro del comitato
卫星	wèi xīng	satellitare
喂	wèi	ciao (verbo)
慰问	wèi wèn	condoglianze
未免	wèi miǎn	inevitabile
畏惧	wèi jù	paura
蔚蓝	wèi lán	azzurro
温带	wēn dài	zona temperata
温和	wēn hé	blando
文凭	wén píng	diploma
文物	wén wù	reliquie culturali
文献	wén xiàn	letteratura
文雅	wén yǎ	elegante
文艺	wén yì	arte
问世	wèn shì	vieni fuori
窝	wō	nido
乌黑	wū hēi	jet black
污蔑	wū miè	calunnia
诬陷	wū xiàn	telaio
无比	wú bǐ	estremamente
无偿	wú cháng	gratuito
无耻	wú chǐ	senza vergogna
无动于衷	wú dòng yú zhōng	indifferente
无非	wú fēi	niente più di
无辜	wú gū	innocente
无精打采	wú jīng dǎ cǎi	svogliato
无赖	wú lài	rogue
无理取闹	wú lǐ qǔ nào	irragionevole
无能为力	wú néng wéi lì	impotente
无穷无尽	wú qióng wú jìn	infinito
无微不至	wú wēi bù zhì	meticoloso
无忧无虑	wú yōu wú lv4	spensierato
无知	wú zhī	ignoranza
侮辱	wǔ rǔ	insulto
武器	wǔ qì	braccia
武侠	wǔ xiá	arti marziali
武装	wǔ zhuāng	armato
舞蹈	wǔ dǎo	danza
务必	wù bì	essere sicuro
物美价廉	wù měi jià lián	buona qualità ed economico
物业	wù yè	proprietà
物资	wù zī	forniture
误差	wù chā	errore
误解	wù jiě	malinteso
夕阳	xī yáng	tramonto
昔日	xī rì	vecchi tempi
溪	xī	torrente
熄灭	xī miè	esci
牺牲	xī shēng	sacrificio
膝盖	xī gài	ginocchio
习俗	xí sú	personalizzato
媳妇	xí fu	nuora
袭击	xí jī	assalto
喜闻乐见	xǐ wén lè jiàn	mi piace sentire
喜悦	xǐ yuè	gioia
系列	xì liè	serie
细菌	xì jūn	batterica
细胞	xì bāo	cellula
细致	xì zhì	meticoloso
峡谷	xiá gǔ	canyon
狭隘	xiá ài	stretto
狭窄	xiá zhǎi	stretto
霞	xiá	xia
下属	xià shǔ	subordinare
先进	xiān jìn	avanzate
先前	xiān qián	in precedenza
掀起	xiān qǐ	partire
纤维	xiān wéi	fibra
鲜明	xiān míng	luminoso
嫌	xián	antipatia
嫌疑	xián yí	sospettare
弦	xián	corda
衔接	xián jiē	connessione
贤惠	xián huì	virtuoso
闲话	xián huà	pettegolezzo
显著	xiǎn zhù	significativo
宪法	xiàn fǎ	costituzione
现场	xiàn chǎng	sul posto
现成	xiàn chéng	pronto
现状	xiàn zhuàng	status quo
线索	xiàn suǒ	traccia
陷害	xiàn hài	incorniciato
陷阱	xiàn jǐng	trappola
陷入	xiàn rù	cadere in
馅儿	xiàn r	ripieno
乡镇	xiāng zhèn	township
相差	xiāng chà	differenza
相等	xiāng děng	pari
相辅相成	xiāng fǔ xiāng chéng	si completano a vicenda
相应	xiāng yìng	corrispondente
镶嵌	xiāng qiàn	mosaico
响亮	xiǎng liàng	forte
响应	xiǎng yìng	risposta
想方设法	xiǎng fāng shè fǎ	trova modi
向导	xiàng dǎo	guida
向来	xiàng lái	sempre
向往	xiàng wǎng	aspetta
巷	xiàng	corsia
相声	xiàng sheng	diafonia
消除	xiāo chú	eliminare
消毒	xiāo dú	disinfettare
消防	xiāo fáng	antincendio
消耗	xiāo hào	consumare
消灭	xiāo miè	spazzar via
潇洒	xiāo sǎ	chic
销毁	xiāo huǐ	distruggere
小心翼翼	xiǎo xīn yì yì	con cautela
效益	xiào yì	vantaggio
肖像	xiào xiàng	ritratto
协会	xié huì	associazione
协商	xié shāng	negoziare
协调	xié tiáo	coordinazione
协议	xié yì	protocollo
协助	xié zhù	assistere
携带	xié dài	trasportare
屑	xiè	briciole
泄露	xiè lù	dare la precedenza
泄气	xiè qì	scoraggiato
谢绝	xiè jué	declino
心得	xīn dé	esperienza
心甘情愿	xīn gān qíng yuàn	volentieri
心灵	xīn líng	anima
心态	xīn tài	mentalità
心疼	xīn téng	angosciato
心血	xīn xuè	lavoro duro
心眼儿	xīn yǎn r	consapevole
新陈代谢	xīn chén dài xiè	metabolismo
新郎	xīn láng	sposo
新娘	xīn niáng	sposa
新颖	xīn yǐng	romanzo
欣慰	xīn wèi	gratificato
欣欣向荣	xīn xīn xiàng róng	fiorente
薪水	xīn shuǐ	stipendio
辛勤	xīn qín	lavoro duro
信赖	xìn lài	fiducia
信念	xìn niàn	credenza
信仰	xìn yǎng	fede
信誉	xìn yù	reputazione
兴高采烈	xīng gāo cǎi liè	euforico
兴隆	xīng lóng	prospero
兴旺	xīng wàng	fiorente
腥	xīng	di pesce
刑事	xíng shì	penale
形态	xíng tài	modulo
行政	xíng zhèng	amministrativo
兴致勃勃	xìng zhì bó bó	eccitato
性感	xìng gǎn	sexy
性命	xìng mìng	vita
性能	xìng néng	prestazione
凶恶	xiōng è	vizioso
凶手	xiōng shǒu	assassino
汹涌	xiōng yǒng	turbolento
胸怀	xiōng huái	mente
胸膛	xiōng táng	il petto
雄厚	xióng hòu	forte
雄伟	xióng wěi	maestoso
修复	xiū fù	riparazione
修建	xiū jiàn	costruire
修养	xiū yǎng	formazione
羞耻	xiū chǐ	vergogna
嗅觉	xiù jué	odore
绣	xiù	ricamare
虚假	xū jiǎ	falso
虚荣	xū róng	vanità
虚伪	xū wěi	ipocrita
需求	xū qiú	richiesta
须知	xū zhī	avviso
许可	xǔ kě	licenza
序言	xù yán	prefazione
畜牧	xù mù	allevamento di animali
酗酒	xù jiǔ	alcolismo
喧哗	xuān huá	tumulto
宣誓	xuān shì	fai un giuramento
宣扬	xuān yáng	predicare
悬挂	xuán guà	sospensione
悬念	xuán niàn	suspense
悬殊	xuán shū	disparità
悬崖峭壁	xuán yá qiào bì	scogliere
旋律	xuán lv4	melodia
旋转	xuán zhuǎn	rotazione
选拔	xuǎn bá	selezione
选举	xuǎn jǔ	elezione
选手	xuǎn shǒu	giocatore
炫耀	xuàn yào	esibire
削	xuē	tagliare
削弱	xuē ruò	indebolire
学说	xué shuō	teoria
学位	xué wèi	laurea di scienza
雪上加霜	xuě shàng jiā shuāng	peggio
血压	xuè yā	pressione sanguigna
熏陶	xūn táo	edificare
寻觅	xún mì	trova
巡逻	xún luó	pattuglia
循环	xún huán	ciclo
循序渐进	xún xù jiàn jìn	passo dopo passo
压迫	yā pò	oppressione
压岁钱	yā suì qián	soldi di capodanno
压缩	yā suō	compressione
压抑	yā yì	depresso
压榨	yā zhà	stampa
压制	yā zhì	sopprimere
鸦雀无声	yā què wú shēng	silenzioso
亚军	yà jūn	secondo classificato
淹没	yān mò	sommerso
烟花爆竹	yān huā bào zhú	petardi
严峻	yán jùn	acuto
严寒	yán hán	forte freddo
严禁	yán jìn	severamente vietato
严厉	yán lì	acuto
严密	yán mì	stretto
岩石	yán shí	roccia
延期	yán qī	estensione
延伸	yán shēn	estendere
延续	yán xù	continua
沿海	yán hǎi	costiero
炎热	yán rè	caldo
言论	yán lùn	discorso
掩盖	yǎn gài	copertina
掩护	yǎn hù	copertina
掩饰	yǎn shì	coprire
演变	yǎn biàn	evoluzione
演习	yǎn xí	esercizio
演绎	yǎn yì	deduzione
演奏	yǎn zòu	giocando
眼光	yǎn guāng	visione
眼色	yǎn sè	occhiolino
眼神	yǎn shén	guarda
厌恶	yàn wù	disgusto
验收	yàn shōu	accettazione
验证	yàn zhèng	verifica
氧气	yǎng qì	ossigeno
样品	yàng pǐn	campione
摇摆	yáo bǎi	swing
摇滚	yáo gǔn	roccia
谣言	yáo yán	pettegolezzo
遥控	yáo kòng	telecomando
遥远	yáo yuǎn	distante
耀眼	yào yǎn	abbagliante
要点	yào diǎn	punto
要命	yào mìng	terribile
要素	yào sù	elemento
野蛮	yě mán	brutale
野心	yě xīn	ambizione
液体	yè tǐ	liquido
一流	yī liú	prima classe
一如既往	yī rú jì wǎng	come sempre
依旧	yī jiù	ancora
依据	yī jù	in accordo con
依靠	yī kào	fare affidamento
依赖	yī lài	fare affidamento
依托	yī tuō	fare affidamento su
衣裳	yī shang	abiti
一度	yí dù	una volta
一贯	yí guàn	coerente
一目了然	yí mù liǎo rán	a prima vista
一向	yí xiàng	sempre
仪器	yí qì	strumento
仪式	yí shì	cerimonia
疑惑	yí huò	dubbio
遗产	yí chǎn	eredità
遗传	yí chuán	genetico
遗留	yí liú	legacy
遗失	yí shī	perduto
以便	yǐ biàn	così che
以免	yǐ miǎn	in modo da non farlo
以往	yǐ wǎng	nel passato
以至	yǐ zhì	anche
以致	yǐ zhì	così che
一帆风顺	yì fān fēng shùn	navigazione tranquilla
一举两得	yì jǔ liǎng dé	prendere due piccioni con una fava
一丝不苟	yì sī bù gǒu	meticoloso
亦	yì	anche
异常	yì cháng	anormale
意料	yì liào	previsto
意识	yì shí	consapevolezza
意图	yì tú	intenzione
意味着	yì wèi zhe	significare
意向	yì xiàng	intenzione
意志	yì zhì	volere
毅力	yì lì	perseveranza
毅然	yì rán	risolutamente
翼	yì	ala
阴谋	yīn móu	cospirazione
音响	yīn xiǎng	suono
引导	yǐn dǎo	guida
引擎	yǐn qíng	motore
引用	yǐn yòng	citazione
隐蔽	yǐn bì	nascosto
隐患	yǐn huàn	pericolo nascosto
隐瞒	yǐn mán	nascondere
隐私	yǐn sī	privacy
隐约	yǐn yuē	svenire
饮食	yǐn shí	dieta
婴儿	yīng ér	bambino
英明	yīng míng	saggio
英勇	yīng yǒng	eroico
盈利	yíng lì	profitto
迎面	yíng miàn	di petto
应酬	yìng chou	socializzare
应邀	yìng yāo	sii invitato
庸俗	yōng sú	volgare
拥护	yōng hù	supporto
拥有	yōng yǒu	avere
勇于	yǒng yú	coraggioso
永恒	yǒng héng	eterno
涌现	yǒng xiàn	emergere
踊跃	yǒng yuè	attivamente
用户	yòng hù	utente
优胜劣汰	yōu shèng liè tài	la sopravvivenza del più forte
优先	yōu xiān	priorità
优异	yōu yì	eccellente
优越	yōu yuè	superiore
忧郁	yōu yù	malinconia
油腻	yóu nì	unto
油漆	yóu qī	dipingere
犹如	yóu rú	come se
有条不紊	yǒu tiáo bù wěn	metodico
幼稚	yòu zhì	ingenuo
诱惑	yòu huò	within temptation
愚蠢	yú chǔn	sciocco
愚昧	yú mèi	ignoranza
渔民	yú mín	pescatori
舆论	yú lùn	opinione pubblica
与日俱增	yǔ rì jù zēng	aumentando di giorno in giorno
宇宙	yǔ zhòu	universo
羽绒服	yǔ róng fú	piumino
寓言	yù yán	favola
愈	yù	guarire
欲望	yù wàng	desiderio
熨	yù	stirare
玉	yù	giada
预料	yù liào	previsto
预期	yù qī	previsto
预算	yù suàn	budget
预先	yù xiān	progredire
预言	yù yán	profezia
预兆	yù zhào	presagio
冤枉	yuān wang	sbagliato
元首	yuán shǒu	capo di stato
元素	yuán sù	elemento
元宵节	yuán xiāo jié	festival delle lanterne
原告	yuán gào	querelante
原理	yuán lǐ	principio
原始	yuán shǐ	originale
原先	yuán xiān	originale
园林	yuán lín	giardino
圆满	yuán mǎn	completare
源泉	yuán quán	fonte
缘故	yuán gù	motivo
约束	yuē shù	vincolo
乐谱	yuè pǔ	spartito
岳母	yuè mǔ	suocera
孕育	yùn yù	allevato
蕴藏	yùn cáng	contenere
运算	yùn suàn	calcolo
运行	yùn xíng	correre
酝酿	yùn niàng	brewing
杂技	zá jì	acrobazie
杂交	zá jiāo	ibridazione
砸	zá	distruggere
咋	zǎ	come
栽培	zāi péi	coltivazione
灾难	zāi nàn	disastro
宰	zǎi	macellazione
再接再厉	zài jiē zài lì	fare sforzi persistenti
在意	zài yì	cura
攒	zǎn	salva
暂且	zàn qiě	per ora
赞叹	zàn tàn	ammirare
赞助	zàn zhù	sponsor
糟蹋	zāo tà	rovinare
遭受	zāo shòu	soffrire
遭殃	zāo yāng	soffrire
遭遇	zāo yù	incontrare
噪音	zào yīn	rumore
造型	zào xíng	modellazione
责怪	zé guài	colpa
贼	zéi	ladro
增添	zēng tiān	inserisci
赠送	zèng sòng	regalare
扎	zhā	cravatta
扎实	zhā shi	solido
渣	zhā	scorie
眨	zhǎ	sbattere le palpebre
诈骗	zhà piàn	frode
摘要	zhāi yào	sommario
债券	zhài quàn	legame
沾光	zhān guāng	tuffo
瞻仰	zhān yǎng	rendi omaggio a
展示	zhǎn shì	esibire
展望	zhǎn wàng	prospettiva
展现	zhǎn xiàn	esibire
崭新	zhǎn xīn	nuovo di zecca
斩钉截铁	zhǎn dīng jié tiě	decisamente
占据	zhàn jù	occupare
占领	zhàn lǐng	occupato
战斗	zhàn dòu	combattimenti
战略	zhàn lvè	strategia
战术	zhàn shù	tattiche
战役	zhàn yì	battaglia
章程	zhāng chéng	carta
帐篷	zhàng peng	tenda
障碍	zhàng ài	ostacolo
招标	zhāo biāo	fare offerte
招收	zhāo shōu	reclutare
朝气蓬勃	zhāo qì péng bó	vigoroso
着迷	zháo mí	affascinato
沼泽	zhǎo zé	palude
照样	zhào yàng	ancora
照耀	zhào yào	splendere
折腾	zhē teng	lanciare
遮挡	zhē dǎng	occludere
折	zhé	piega
折磨	zhé mó	torturato
侦探	zhēn tàn	detective
斟酌	zhēn zhuó	prendere in considerazione
珍贵	zhēn guì	prezioso
珍稀	zhēn xī	raro
珍珠	zhēn zhū	perla
真理	zhēn lǐ	verità
真相	zhēn xiàng	la verità
真挚	zhēn zhì	sincero
枕头	zhěn tou	cuscino
振奋	zhèn fèn	uplift
振兴	zhèn xīng	rivitalizza
镇定	zhèn dìng	calma
镇静	zhèn jìng	calma
阵地	zhèn dì	posizione
阵容	zhèn róng	allineare
震撼	zhèn hàn	shock
震惊	zhèn jīng	shock
争端	zhēng duān	disputa
争夺	zhēng duó	contesa
争气	zhēng qì	vincere
争先恐后	zhēng xiān kǒng hòu	rimescolando
争议	zhēng yì	disputa
征服	zhēng fú	conquistare
征收	zhēng shōu	collezione
挣扎	zhēng zhá	lotta
正月	zhēng yuè	primo mese
蒸发	zhēng fā	evaporazione
整顿	zhěng dùn	rettifica
政策	zhèng cè	politica
政权	zhèng quán	regime
正当	zhèng dāng	giustificato
正负	zhèng fù	positivo e negativo
正规	zhèng guī	regolare
正经	zhèng jing	grave
正气	zhèng qì	rettitudine
正义	zhèng yì	giustizia
正宗	zhèng zōng	autentico
症状	zhèng zhuàng	sintomo
证实	zhèng shí	confermare
证书	zhèng shū	certificato
郑重	zhèng zhòng	solennemente
之际	zhī jì	in occasione
支撑	zhī chēng	supporto
支出	zhī chū	spesa
支流	zhī liú	affluente
支配	zhī pèi	dominare
支援	zhī yuán	supporto
支柱	zhī zhù	pilastro
枝	zhī	ramo
知觉	zhī jué	percezione
知足常乐	zhī zú cháng lè	contentezza
脂肪	zhī fáng	grasso
侄子	zhí zi	nipote
值班	zhí bān	in servizio
执行	zhí xíng	effettuata
执着	zhí zhuó	persistenza
殖民地	zhí mín dì	colonia
直播	zhí bō	trasmissione in diretta
直径	zhí jìng	diametro
职能	zhí néng	funzione
职位	zhí wèi	posizione
职务	zhí wù	posizione
指标	zhǐ biāo	indice
指定	zhǐ dìng	specificare
指甲	zhǐ jia	chiodi
指令	zhǐ lìng	istruzione
指南针	zhǐ nán zhēn	bussola
指示	zhǐ shì	istruzioni
指望	zhǐ wàng	contare su
指责	zhǐ zé	accusare
制裁	zhì cái	sanzioni
制服	zhì fú	uniforme
制约	zhì yuē	contenzione
制止	zhì zhǐ	stop
志气	zhì qì	ambizione
智力	zhì lì	intelligenza
智能	zhì néng	intelligente
智商	zhì shāng	iq
治安	zhì ān	legge e ordine
治理	zhì lǐ	governance
滞留	zhì liú	rimanere
致辞	zhì cí	indirizzo
致力	zhì lì	impegnato con
致使	zhì shǐ	causa
中断	zhōng duàn	interrompere
中立	zhōng lì	neutro
中央	zhōng yāng	centrale
忠诚	zhōng chéng	lealtà
忠实	zhōng shí	leale
终点	zhōng diǎn	fine
终究	zhōng jiū	dopotutto
终身	zhōng shēn	per tutta la vita
终止	zhōng zhǐ	risoluzione
衷心	zhōng xīn	sincero
种子	zhǒng zi	seme
种族	zhǒng zú	gara
肿瘤	zhǒng liú	tumore
众所周知	zhòng suǒ zhōu zhī	ben noto
种植	zhòng zhí	piantare
重心	zhòng xīn	centro di gravità
周边	zhōu biān	circostante
周密	zhōu mì	attento
周年	zhōu nián	anniversario
周期	zhōu qī	ciclo
周折	zhōu zhé	girarsi
周转	zhōu zhuǎn	turnover
州	zhōu	stato
粥	zhōu	porridge
舟	zhōu	barca
昼夜	zhòu yè	giorno e notte
皱纹	zhòu wén	grinza
株	zhū	sforzo
诸位	zhū wèi	tutti
逐年	zhú nián	anno per anno
主办	zhǔ bàn	ospite
主导	zhǔ dǎo	leader
主管	zhǔ guǎn	supervisore
主流	zhǔ liú	mainstream
主权	zhǔ quán	sovranità
主义	zhǔ yì	dottrina
嘱咐	zhǔ fù	esortare
拄	zhǔ	spremere
住宅	zhù zhái	residenziale
助理	zhù lǐ	assistant manager
助手	zhù shǒu	assistente
注射	zhù shè	iniezione
注视	zhù shì	guarda a
注释	zhù shì	commento
注重	zhù zhòng	prestare attenzione a
著作	zhù zuò	libro
铸造	zhù zào	casting
驻扎	zhù zhā	di stanza
拽	zhuài	trascinare
专长	zhuān cháng	competenza
专程	zhuān chéng	viaggio speciale
专利	zhuān lì	brevetto
专题	zhuān tí	argomento
砖	zhuān	mattone
转达	zhuǎn dá	trasmettere
转让	zhuǎn ràng	trasferimento
转移	zhuǎn yí	trasferimento
转折	zhuǎn zhé	punto di svolta
传记	zhuàn jì	biografia
庄稼	zhuāng jià	colture
庄严	zhuāng yán	solenne
庄重	zhuāng zhòng	solenne
装备	zhuāng bèi	attrezzature
装卸	zhuāng xiè	caricamento e scaricamento
壮观	zhuàng guān	spettacolare
壮丽	zhuàng lì	magnifico
壮烈	zhuàng liè	eroico
幢	zhuàng	costruzione
追悼	zhuī dào	memoriale
追究	zhuī jiū	indagare
坠	zhuì	autunno
准则	zhǔn zé	linee guida
卓越	zhuó yuè	eccellenza
琢磨	zhuó mó	riflettere
着手	zhuó shǒu	accingersi
着想	zhuó xiǎng	per il bene di
着重	zhuó zhòng	concentrarsi su
姿态	zī tài	atteggiamento
滋润	zī rùn	idratare
滋味	zī wèi	gusto
资本	zī běn	capitale
资产	zī chǎn	risorse
资深	zī shēn	anziano
资助	zī zhù	finanziamento
子弹	zǐ dàn	proiettile
自卑	zì bēi	inferiorità
自发	zì fā	spontaneo
自力更生	zì lì gēng shēng	fiducia in se stessi
自满	zì mǎn	compiacente
自主	zì zhǔ	autonomo
宗教	zōng jiào	religione
宗旨	zōng zhǐ	scopo
棕色	zōng sè	marrone
踪迹	zōng jì	traccia
总而言之	zǒng ér yán zhī	tutto sommato
总和	zǒng hé	somma
纵横	zòng héng	verticale e orizzontale
走廊	zǒu láng	corridoio
走漏	zǒu lòu	perdita
走私	zǒu sī	contrabbando
揍	zòu	battere
租赁	zū lìn	contratto di locazione
足以	zú yǐ	sufficiente
祖父	zǔ fù	nonno
祖国	zǔ guó	patria
祖先	zǔ xiān	antenato
阻碍	zǔ ài	ostacolare
阻拦	zǔ lán	stop
阻挠	zǔ náo	ostacolare
钻研	zuān yán	immergiti
钻石	zuàn shí	diamante
嘴唇	zuǐ chún	labbra
罪犯	zuì fàn	penale
尊严	zūn yán	dignità
遵循	zūn xún	seguire
作弊	zuò bì	truffare
作废	zuò fèi	void
作风	zuò fēng	stile
作息	zuò xī	riposo
做主	zuò zhǔ	chiamare i colpi
座右铭	zuò yòu míng	motto
