哎	āi	hey
唉	āi	uffa
爱护	ài hù	cherish
爱惜	ài xī	amare
爱心	ài xīn	amore
安慰	ān wèi	comfort
安装	ān zhuāng	installazione
岸	àn	puntellare
暗	àn	buio
熬夜	áo yè	stare alzato fino a tardi
把握	bǎ wò	afferrare
摆	bǎi	mettere
办理	bàn lǐ	maniglia
傍晚	bàng wǎn	sera
包裹	bāo guǒ	pacchetto
包含	bāo hán	contenere
包括	bāo kuò	includere
薄	báo	magro
保持	bǎo chí	mantenere
保存	bǎo cún	salva
保留	bǎo liú	mantenere
保险	bǎo xiǎn	assicurazione
宝贝	bǎo bèi	bambino
宝贵	bǎo guì	prezioso
报到	bào dào	registrare
报道	bào dào	rapporto
报告	bào gào	rapporto
报社	bào shè	giornale
抱怨	bào yuàn	lamentarsi
悲观	bēi guān	pessimista
背	bèi	indietro
背景	bèi jǐng	sfondo
被子	bèi zi	trapunta
本科	běn kē	laureato
本领	běn lǐng	capacità
本质	běn zhì	natura
彼此	bǐ cǐ	l'un l'altro
比例	bǐ lì	proporzione
必然	bì rán	inevitabile
必要	bì yào	necessario
毕竟	bì jìng	dopotutto
避免	bì miǎn	evitare
编辑	biān jí	modificare
鞭炮	biān pào	petardo
便	biàn	cacca
辩论	biàn lùn	discussione
标点	biāo diǎn	punteggiatura
标志	biāo zhì	cartello
表达	biǎo dá	espressione
表面	biǎo miàn	superficie
表明	biǎo míng	mostrare
表情	biǎo qíng	espressione
表现	biǎo xiàn	che ha eseguito
冰激凌	bīng jī líng	gelato
病毒	bìng dú	virus
播放	bō fàng	giocare
玻璃	bō li	bicchiere
博物馆	bó wù guǎn	museo
脖子	bó zi	collo
不断	bú duàn	continua
不见得	bú jiàn de	non necessariamente
不耐烦	bú nài fán	impaziente
不要紧	bú yào jǐn	non importa
补充	bǔ chōng	supplemento
不安	bù ān	disturbato
不得了	bù dé liǎo	terribile
不然	bù rán	altrimenti
不如	bù rú	non così buono come
不足	bù zú	insufficiente
布	bù	stoffa
步骤	bù zhòu	passo
部门	bù mén	dipartimento
财产	cái chǎn	proprietà
彩虹	cǎi hóng	arcobaleno
踩	cǎi	calpestare
采访	cǎi fǎng	colloquio
采取	cǎi qǔ	prendere
参考	cān kǎo	riferimento
参与	cān yù	partecipare
惭愧	cán kuì	si vergogna
操场	cāo chǎng	terreno di gioco
操心	cāo xīn	preoccupazione
册	cè	libro
测验	cè yàn	test
曾经	céng jīng	una volta
叉子	chā zi	forchetta
差距	chā jù	divario
插	chā	inserire
拆	chāi	smantellare
产品	chǎn pǐn	prodotto
产生	chǎn shēng	produrre
常识	cháng shí	buon senso
长途	cháng tú	lungo raggio
抄	chāo	copia
超级	chāo jí	super
朝	cháo	in direzione
潮湿	cháo shī	bagnato
吵	chǎo	rumoroso
吵架	chǎo jià	litigare
炒	chǎo	friggere
车库	chē kù	box auto
车厢	chē xiāng	macchina
彻底	chè dǐ	approfondita
沉默	chén mò	silenzio
趁	chèn	approfittare di
称	chēng	pesare
称呼	chēng hu	chiamata
称赞	chēng zàn	lode
成分	chéng fèn	ingrediente
成果	chéng guǒ	risultati
成就	chéng jiù	realizzazione
成立	chéng lì	stabilito
成人	chéng rén	adulto
成熟	chéng shú	maturo
成语	chéng yǔ	idioma
成长	chéng zhǎng	crescendo
承担	chéng dān	orso
承认	chéng rèn	riconoscimento
承受	chéng shòu	orso
程度	chéng dù	grado
程序	chéng xù	programma
诚恳	chéng kěn	sincero
吃亏	chī kuī	soffrire
持续	chí xù	ha continuato
池塘	chí táng	stagno
迟早	chí zǎo	presto o tardi
尺子	chǐ zi	righello
翅膀	chì bǎng	ala
充电器	chōng diàn qì	caricabatterie
充分	chōng fèn	pieno
充满	chōng mǎn	pieno
冲	chōng	rush
重复	chóng fù	ripetere
宠物	chǒng wù	animale domestico
抽屉	chōu ti	cassetto
抽象	chōu xiàng	astratto
丑	chǒu	brutto
臭	chòu	puzzolente
出版	chū bǎn	pubblicazione
出口	chū kǒu	esportare
出色	chū sè	eccezionale
出示	chū shì	mostrare
出席	chū xí	assistere
初级	chū jí	primario
除非	chú fēi	salvo che
除夕	chú xī	vigilia di capodanno
处理	chǔ lǐ	avere a che fare con
传播	chuán bō	diffusione
传染	chuán rǎn	infezione
传说	chuán shuō	leggenda
传统	chuán tǒng	tradizionale
窗帘	chuāng lián	tenda
闯	chuǎng	rush
创造	chuàng zào	creare
吹	chuī	soffio
词汇	cí huì	vocabolario
辞职	cí zhí	dimissioni
此外	cǐ wài	inoltre
刺激	cì jī	stimolare
次要	cì yào	secondario
匆忙	cōng máng	fretta
从此	cóng cǐ	da allora
从而	cóng ér	in tal modo
从前	cóng qián	prima
从事	cóng shì	impegnati
粗糙	cū cāo	ruvido
促进	cù jìn	promuovere
促使	cù shǐ	richiesta
醋	cù	aceto
催	cuī	ricordare
存在	cún zài	esistere
措施	cuò shī	le misure
答应	dā ying	promettere
达到	dá dào	raggiungere
打工	dǎ gōng	lavoro part time
打交道	dǎ jiāo dào	avere a che fare con
打喷嚏	dǎ pēn tì	starnuto
打听	dǎ ting	chiedere su
大方	dà fāng	generoso
大厦	dà shà	costruzione
大象	dà xiàng	elefante
大型	dà xíng	grande
呆	dāi	rimanere
代表	dài biǎo	rappresentante
代替	dài tì	anziché
待遇	dài yù	trattamento
贷款	dài kuǎn	prestito
单纯	dān chún	semplice
单调	dān diào	monotono
单独	dān dú	solo
单位	dān wèi	unità
单元	dān yuán	unità
担任	dān rèn	servire come
耽误	dān wu	sostenere
胆小鬼	dǎn xiǎo guǐ	codardo
淡	dàn	luce
当地	dāng dì	locale
当心	dāng xīn	attenti
挡	dǎng	bloccare
倒霉	dǎo méi	sfortunato
导演	dǎo yǎn	direttore
导致	dǎo zhì	con il risultato di
岛屿	dǎo yǔ	isole
到达	dào dá	arrivi
道德	dào dé	morale
道理	dào lǐ	motivo
登记	dēng jì	registrati
等待	děng dài	aspettare
等于	děng yú	pari
滴	dī	far cadere
敌人	dí rén	nemico
的确	dí què	infatti
地道	dì dao	tipico
地理	dì lǐ	geografia
地区	dì qū	la zona
地毯	dì tǎn	tappeto
地位	dì wèi	stato
地震	dì zhèn	terremoto
递	dì	passaggio
点心	diǎn xin	dolce
电池	diàn chí	batteria
电台	diàn tái	stazione radio
钓	diào	pesca
顶	dǐng	superiore
冻	dòng	congelare
动画片	dòng huà piān	cartone animato
洞	dòng	buco
豆腐	dòu fu	tofu
逗	dòu	stuzzicare
独立	dú lì	indipendente
独特	dú tè	unico
度过	dù guò	trascorrere
断	duàn	rompere
堆	duī	mucchio
兑换	duì huàn	scambio
对比	duì bǐ	rispetto
对待	duì dài	trattare
对方	duì fāng	l'altra parte
对手	duì shǒu	avversario
对象	duì xiàng	oggetto
吨	dūn	tonnellata
蹲	dūn	squat
顿	dùn	pausa
多亏	duō kuī	grazie
多余	duō yú	ridondante
朵	duǒ	fare
躲藏	duǒ cáng	nascondere
恶劣	è liè	cattivo
耳环	ěr huán	orecchino
发表	fā biǎo	pubblicare
发愁	fā chóu	preoccupazione
发达	fā dá	sviluppato
发抖	fā dǒu	tremito
发挥	fā huī	giocare
发明	fā míng	invenzione
发票	fā piào	fattura
发言	fā yán	parlare
罚款	fá kuǎn	bene
法院	fǎ yuàn	tribunale
翻	fān	girare
繁荣	fán róng	prosperità
反而	fǎn ér	anziché
反复	fǎn fù	ripetutamente
反应	fǎn yìng	reazione
反映	fǎn yìng	riflettere
反正	fǎn zhèng	comunque
范围	fàn wéi	gamma
方	fāng	piazza
方案	fāng àn	programma
方式	fāng shì	la via
妨碍	fáng ài	ostacolare
仿佛	fǎng fú	come se
非	fēi	non-
肥皂	féi zào	saponetta
废话	fèi huà	senza senso
分别	fēn bié	rispettivamente
分布	fēn bù	distribuito
分配	fēn pèi	distribuzione
分手	fēn shǒu	rottura
分析	fēn xī	analisi
纷纷	fēn fēn	uno dopo l'altro
奋斗	fèn dòu	lotta
疯狂	fēng kuáng	pazzo
风格	fēng gé	stile
风景	fēng jǐng	paesaggio
风俗	fēng sú	personalizzato
风险	fēng xiǎn	rischio
讽刺	fěng cì	ironia
否定	fǒu dìng	negativo
否认	fǒu rèn	negare
幅	fú	larghezza
扶	fú	aiuto
服装	fú zhuāng	capi di abbigliamento
辅导	fǔ dǎo	istruire
复制	fù zhì	copia
妇女	fù nv3	donne
改革	gǎi gé	riforma
改进	gǎi jìn	ottimizzare
改善	gǎi shàn	ottimizzare
改正	gǎi zhèng	corretta
概括	gài kuò	generalizzare
概念	gài niàn	concetto
盖	gài	copertina
干脆	gān cuì	semplicemente
干燥	gān zào	asciutto
感激	gǎn jī	grato
感受	gǎn shòu	sentire
感想	gǎn xiǎng	pensieri
赶紧	gǎn jǐn	sbrigati
赶快	gǎn kuài	sbrigati
干活儿	gàn huó r	lavoro
钢铁	gāng tiě	acciaio
高档	gāo dàng	di alto livello
高级	gāo jí	avanzate
搞	gǎo	impegnati
告别	gào bié	dire addio
格外	gé wài	particolarmente
隔壁	gé bì	porta accanto
个别	gè bié	individuale
个人	gè rén	personale
个性	gè xìng	personalità
各自	gè zì	rispettivo
根	gēn	radice
根本	gēn běn	fondamentale
公布	gōng bù	annunciare
公开	gōng kāi	pubblico
公平	gōng píng	giusto
公寓	gōng yù	appartamento
公元	gōng yuán	anno domini.
公主	gōng zhǔ	principessa
功能	gōng néng	caratteristiche
工厂	gōng chǎng	fabbrica
工程师	gōng chéng shī	ingegnere
工具	gōng jù	attrezzo
工人	gōng rén	lavoratore
工业	gōng yè	industria
恭喜	gōng xǐ	congratulazioni
贡献	gòng xiàn	contributo
沟通	gōu tōng	comunicazione
构成	gòu chéng	costituire
姑姑	gū gu	zia
姑娘	gū niang	ragazza
古代	gǔ dài	antico
古典	gǔ diǎn	classico
股票	gǔ piào	azione
骨头	gǔ tou	osso
鼓舞	gǔ wǔ	ispirare
鼓掌	gǔ zhǎng	applaudire
固定	gù dìng	fisso
挂号	guà hào	registrato
乖	guāi	essere buono
拐弯	guǎi wān	turn
怪不得	guài bu de	nessuna sorpresa
关闭	guān bì	spegnimento
官	guān	ufficiale
观察	guān chá	osservato
观点	guān diǎn	visualizza
观念	guān niàn	idea
管子	guǎn zǐ	tubo
冠军	guàn jūn	campione
光滑	guāng hua	liscio
光临	guāng lín	venire
光明	guāng míng	luminoso
光盘	guāng pán	cd
广场	guǎng chǎng	piazza
广大	guǎng dà	vasto
广泛	guǎng fàn	ampiamente
归纳	guī nà	induzione
规矩	guī ju	regola
规律	guī lv4	legge
规模	guī mó	scala
规则	guī zé	regola
柜台	guì tái	contatore
滚	gǔn	roll
锅	guō	pentola
国庆节	guó qìng jié	giorno nazionale
国王	guó wáng	re
果然	guǒ rán	veramente
果实	guǒ shí	frutta
过分	guò fèn	eccessivo
过敏	guò mǐn	allergia
过期	guò qī	scaduto
哈	hā	che cosa
海关	hǎi guān	dogana
海鲜	hǎi xiān	frutti di mare
喊	hǎn	chiamata
行业	háng yè	industria
豪华	háo huá	lusso
好客	hào kè	ospitale
好奇	hào qí	curioso
何必	hé bì	perché preoccuparsi
何况	hé kuàng	per non parlare di
合法	hé fǎ	legittimo
合理	hé lǐ	ragionevole
合同	hé tong	contrarre
合影	hé yǐng	foto di gruppo
合作	hé zuò	cooperazione
和平	hé píng	pace
核心	hé xīn	nucleo
恨	hèn	odiare
猴子	hóu zi	scimmia
后背	hòu bèi	indietro
后果	hòu guǒ	come conseguenza di
呼吸	hū xī	respirare
忽然	hū rán	ad un tratto
忽视	hū shì	ignorare
壶	hú	pentola
糊涂	hú tu	confuso
胡说	hú shuō	senza senso
胡同	hú tòng	vicolo
蝴蝶	hú dié	la farfalla
花生	huā shēng	arachidi
华裔	huá yì	cinese
滑	huá	scivolare
划	huà	disegnare
化学	huà xué	chimica
话题	huà tí	argomento
怀念	huái niàn	perdere
怀孕	huái yùn	gravidanza
缓解	huǎn jiě	facilità
幻想	huàn xiǎng	fantasia
慌张	huāng zhāng	panico
黄金	huáng jīn	oro
恢复	huī fù	ristabilire
挥	huī	onda
灰	huī	grigio
灰尘	huī chén	polvere
灰心	huī xīn	scoraggiato
汇率	huì lv4	tasso di cambio
婚礼	hūn lǐ	nozze
婚姻	hūn yīn	matrimonio
活跃	huó yuè	attivo
伙伴	huǒ bàn	compagno
火柴	huǒ chái	partite
或许	huò xǔ	forse
基本	jī běn	di base
机器	jī qì	macchina
激烈	jī liè	feroce
肌肉	jī ròu	muscolo
及格	jí gé	passaggio
急忙	jí máng	frettolosamente
急诊	jí zhěn	emergenza
极其	jí qí	estremamente
集合	jí hé	impostato
集体	jí tǐ	collettivo
集中	jí zhōng	concentrato
寂寞	jì mò	solitario
系领带	jì lǐng dài	indossare una cravatta
纪录	jì lù	disco
纪律	jì lv4	disciplina
纪念	jì niàn	commemorare
计算	jì suàn	calcolo
记录	jì lù	registrazione
记忆	jì yì	memoria
嘉宾	jiā bīn	ospite
夹子	jiā zi	clip
家庭	jiā tíng	famiglia
家务	jiā wù	lavori di casa
家乡	jiā xiāng	città natale
假如	jiǎ rú	se
假设	jiǎ shè	ipotesi
假装	jiǎ zhuāng	fingere
甲	jiǎ	un
价值	jià zhí	valore
嫁	jià	sposare
驾驶	jià shǐ	guidare
兼职	jiān zhí	mezza giornata
坚决	jiān jué	risolutamente
坚强	jiān qiáng	forte
肩膀	jiān bǎng	spalla
艰巨	jiān jù	difficile
艰苦	jiān kǔ	difficile
剪刀	jiǎn dāo	forbici
捡	jiǎn	raccogliere
简历	jiǎn lì	curriculum vitae
简直	jiǎn zhí	semplicemente
健身	jiàn shēn	fitness
建立	jiàn lì	impostare
建设	jiàn shè	costruzione
建筑	jiàn zhù	costruzione
键盘	jiàn pán	tastiera
讲究	jiǎng jiu	prestare attenzione a
讲座	jiǎng zuò	conferenza
酱油	jiàng yóu	salsa di soia
交换	jiāo huàn	scambio
交际	jiāo jì	comunicazione
交往	jiāo wǎng	contatto
浇	jiāo	versare
胶水	jiāo shuǐ	colla
狡猾	jiǎo huá	abile
角度	jiǎo dù	angolo
教材	jiào cái	manuale
教练	jiào liàn	allenatore
教训	jiào xun	lezione
接触	jiē chù	contatto
接待	jiē dài	ricezione
接近	jiē jìn	vicino a
结实	jiē shi	solido
阶段	jiē duàn	palcoscenico
结构	jié gòu	struttura
结合	jié hé	combina
结论	jié lùn	in conclusione
结账	jié zhàng	il conto per favore
节省	jié shěng	salva
借口	jiè kǒu	scusa
届	jiè	sessione
戒	jiè	smettere
戒指	jiè zhi	squillare
金属	jīn shǔ	metallo
尽快	jǐn kuài	al più presto
紧急	jǐn jí	urgente
谨慎	jǐn shèn	prudente
尽力	jìn lì	fai del tuo meglio
尽量	jìn liàng	prova a
近代	jìn dài	tempi moderni
进步	jìn bù	progresso
进口	jìn kǒu	importare
精力	jīng lì	energia
精神	jīng shén	spirito
经典	jīng diǎn	classico
经商	jīng shāng	facendo affari
经营	jīng yíng	operativo
酒吧	jiǔ bā	bar
救	jiù	salva
救护车	jiù hù chē	ambulanza
舅舅	jiù jiu	zio
居然	jū rán	inaspettatamente
桔子	jú zi	arancia
俱乐部	jù lè bù	club
具备	jù bèi	avere
具体	jù tǐ	specifica
巨大	jù dà	enorme
据说	jù shuō	si dice che
捐	juān	donare
决赛	jué sài	finale
决心	jué xīn	determinazione
绝对	jué duì	assoluto
角色	jué sè	ruoli
军事	jūn shì	militare
均匀	jūn yún	in modo uniforme
卡车	kǎ chē	camion
开发	kāi fā	sviluppo
开放	kāi fàng	aperto
开幕式	kāi mù shì	cerimonia di apertura
开水	kāi shuǐ	acqua bollente
砍	kǎn	tagliare
看不起	kàn bu qǐ	disprezzare
看望	kàn wàng	visita
靠	kào	di
颗	kē	pezzi
可见	kě jiàn	visibile
可靠	kě kào	affidabile
可怕	kě pà	terribile
克	kè	grammo
克服	kè fú	superare
刻苦	kè kǔ	lavoro duro
客观	kè guān	obbiettivo
课程	kè chéng	corso
空间	kōng jiān	spazio
控制	kòng zhì	controllo
空闲	kòng xián	inattivo
口味	kǒu wèi	gusto
夸	kuā	vantarsi
夸张	kuā zhāng	esagerazione
会计	kuài jì	contabilità
宽	kuān	larghezza
昆虫	kūn chóng	insetto
扩大	kuò dà	espandere
辣椒	là jiāo	chili
拦	lán	bar
烂	làn	marcio
朗读	lǎng dú	leggere ad alta voce
劳动	láo dòng	lavoro duro e faticoso
劳驾	láo jià	mi scusi
姥姥	lǎo lao	nonna
老百姓	lǎo bǎi xìng	gente comune
老板	lǎo bǎn	capo
老婆	lǎo pó	moglie
老实	lǎo shi	onesto
老鼠	lǎo shǔ	topo
乐观	lè guān	ottimismo
雷	léi	il mio
类型	lèi xíng	tipi di
冷淡	lěng dàn	freddo
厘米	lí mǐ	centimetro
梨	lí	pera
离婚	lí hūn	divorzio
理论	lǐ lùn	teoria
理由	lǐ yóu	motivo
利润	lì rùn	profitto
利息	lì xī	interesse
利益	lì yì	interesse
利用	lì yòng	uso
力量	lì liang	energia
立即	lì jí	subito
立刻	lì kè	subito
联合	lián hé	comune
连忙	lián máng	velocemente
连续	lián xù	continuo
恋爱	liàn ài	innamorato
粮食	liáng shi	cibo
良好	liáng hǎo	bene
亮	liàng	luminoso
了不起	liǎo bu qǐ	sorprendente
列车	liè chē	treno
临时	lín shí	temporaneo
灵活	líng huó	flessibile
铃	líng	campana
零件	líng jiàn	componenti
零食	líng shí	spuntini
领导	lǐng dǎo	comando
领域	lǐng yù	campo
流传	liú chuán	diffusione
流泪	liú lèi	lacrime
浏览	liú lǎn	navigare
龙	lóng	drago
漏	lòu	perdita
录取	lù qǔ	ammissione
录音	lù yīn	registrazione
陆地	lù dì	sbarcare
陆续	lù xù	uno dopo l'altro
轮流	lún liú	girare
论文	lùn wén	carta
逻辑	luó ji	logica
落后	luò hòu	dietro a
骂	mà	maledizione
麦克风	mài kè fēng	microfono
馒头	mán tou	pane al vapore
满足	mǎn zú	soddisfare
毛病	máo bìng	colpa
矛盾	máo dùn	contraddizione
冒险	mào xiǎn	avventura
贸易	mào yì	trading
媒体	méi tǐ	media
煤炭	méi tàn	carbone
眉毛	méi mao	sopracciglio
美术	měi shù	arte
魅力	mèi lì	fascino
梦想	mèng xiǎng	sognare
密切	mì qiè	vicino
秘密	mì mì	segreto
秘书	mì shū	segretario
蜜蜂	mì fēng	ape
面对	miàn duì	viso
面积	miàn jī	la zona
面临	miàn lín	di fronte
描写	miáo xiě	descrizione
苗条	miáo tiáo	sottile
敏感	mǐn gǎn	sensibile
名牌	míng pái	marchio famoso
名片	míng piàn	biglietto da visita
名胜古迹	míng shèng gǔ jì	luoghi di interesse
明确	míng què	chiaro
明显	míng xiǎn	ovvio
明星	míng xīng	celebrità
命令	mìng lìng	comando
命运	mìng yùn	destino
摸	mō	toccare
摩托车	mó tuō chē	motociclo
模仿	mó fǎng	imitare
模糊	mó hu	sfocato
模特	mó tè	modello
陌生	mò shēng	strano
某	mǒu	certo
木头	mù tou	legna
目标	mù biāo	obiettivi
目录	mù lù	sommario
目前	mù qián	attualmente
哪怕	nǎ pà	anche se
难怪	nán guài	nessuna sorpresa
难免	nán miǎn	inevitabile
脑袋	nǎo dài	capo
内部	nèi bù	interno
内科	nèi kē	medicina interna
嫩	nèn	tenero
能干	néng gàn	capace
能源	néng yuán	energia
嗯	ńg	ok
年代	nián dài	anni
年纪	nián jì	età
念	niàn	leggere
宁可	nìng kě	piuttosto
牛仔裤	niú zǎi kù	jeans
农村	nóng cūn	area rurale
农民	nóng mín	contadino
农业	nóng yè	agricoltura
浓	nóng	concentrato
女士	nv3 shì	sm
欧洲	ōu zhōu	europa
偶然	ǒu rán	accidentale
拍	pāi	sparare
派	pài	spedire
盼望	pàn wàng	speranza
培训	péi xùn	formazione
培养	péi yǎng	coltivare
赔偿	péi cháng	compensazione
佩服	pèi fú	ammirare
配合	pèi hé	cooperare
盆	pén	pentole
碰	pèng	urto
批	pī	lotto
批准	pī zhǔn	approvare
披	pī	phi
疲劳	pí láo	fatica
匹	pǐ	incontro
片	piàn	foglio
片面	piàn miàn	unilaterale
飘	piāo	con il vento
拼音	pīn yīn	pinyin
频道	pín dào	canale
凭	píng	fare affidamento su
平均	píng jūn	media
平	píng	livello
平安	píng 'ān	sicuro
平常	píng cháng	generalmente
平等	píng děng	uguaglianza
平方	píng fāng	piazza
平衡	píng héng	equilibrio
平静	píng jìng	calma
评价	píng jià	valutazione
破产	pò chǎn	fallimento
破坏	pò huài	danno
迫切	pò qiè	urgente
期待	qī dài	non vedere l'ora di
期间	qī jiān	periodo
其余	qí yú	il resto
奇迹	qí jì	miracolo
企业	qǐ yè	impresa
启发	qǐ fā	illuminare
气氛	qì fēn	atmosfera
汽油	qì yóu	benzina
签	qiān	cartello
谦虚	qiān xū	modesto
前途	qián tú	futuro
浅	qiǎn	superficiale
欠	qiàn	devo
枪	qiāng	pistola
墙	qiáng	parete
强调	qiáng diào	enfatizzare
强烈	qiáng liè	forte
抢	qiǎng	afferrare
悄悄	qiāo qiāo	tranquillamente
瞧	qiáo	guarda
巧妙	qiǎo miào	intelligente
切	qiē	tagliare
亲爱	qīn ài	caro
亲切	qīn qiè	genere
亲自	qīn zì	personalmente
勤奋	qín fèn	diligente
清淡	qīng dàn	luce
轻视	qīng shì	disprezzo
轻易	qīng yì	facilmente
青	qīng	verde
青春	qīng chūn	gioventù
青少年	qīng shào nián	adolescenti
情景	qíng jǐng	scena
情绪	qíng xù	umore
请求	qǐng qiú	richiesta
庆祝	qìng zhù	celebrare
球迷	qiú mí	fan
趋势	qū shì	tendenza
取消	qǔ xiāo	annulla
娶	qǔ	sposare
去世	qù shì	deceduto
圈	quān	squillare
全面	quán miàn	completo
权利	quán lì	giusto
权力	quán lì	quella potenza
劝	quàn	consigliare
缺乏	quē fá	mancanza di
确定	què dìng	determinare
确认	què rèn	confermare
群	qún	gruppo
燃烧	rán shāo	combustione
绕	rào	in giro
热爱	rè ài	amore
热烈	rè liè	caldo
热心	rè xīn	entusiasta
人才	rén cái	talento
人口	rén kǒu	popolazione
人类	rén lèi	umanità
人民币	rén mín bì	rmb
人生	rén shēng	vita
人事	rén shì	personale
人物	rén wù	carattere
人员	rén yuán	personale
忍不住	rěn bu zhù	non posso aiutare
日常	rì cháng	quotidiano
日程	rì chéng	programma
日历	rì lì	calendario
日期	rì qī	data
日用品	rì yòng pǐn	necessità giornaliere
日子	rì zi	giorno
如何	rú hé	com'è
如今	rú jīn	adesso
软	ruǎn	morbido
软件	ruǎn jiàn	software
弱	ruò	debole
洒	sǎ	cospargere
嗓子	sǎng zi	voce
色彩	sè cǎi	colore
杀	shā	uccidere
沙漠	shā mò	deserto
沙滩	shā tān	spiaggia
傻	shǎ	stupido
晒	shài	mostrare
删除	shān chú	elimina
闪电	shǎn diàn	fulmini
善良	shàn liáng	gentilezza
善于	shàn yú	bravo a
扇子	shàn zi	fan
伤害	shāng hài	male
商品	shāng pǐn	merce
商务	shāng wù	attività commerciale
商业	shāng yè	attività commerciale
上当	shàng dàng	ingannato
蛇	shé	serpente
舍不得	shě bu de	riluttante
射击	shè jī	tiro
摄影	shè yǐng	la fotografia
设备	shè bèi	attrezzature
设计	shè jì	design
设施	shè shī	servizio, struttura
伸	shēn	allungare
深刻	shēn kè	profondo
身材	shēn cái	figura
身份	shēn fèn	identità
神话	shén huà	mito
神秘	shén mì	misterioso
升	shēng	alzati
声调	shēng diào	tono
生产	shēng chǎn	produrre
生动	shēng dòng	vivido
生长	shēng zhǎng	crescere
绳子	shéng zi	corda
省略	shěng lüè	omettere
胜利	shèng lì	vittoria
失眠	shī mián	insonnia
失去	shī qù	perdere
失业	shī yè	disoccupazione
湿润	shī rùn	umido
狮子	shī zi	leone
诗	shī	poesia
实话	shí huà	verità
实践	shí jiàn	pratica
实习	shí xí	pratica
实现	shí xiàn	raggiungere
实验	shí yàn	sperimentare
实用	shí yòng	pratico
时差	shí chā	disritmia
时代	shí dài	era
时刻	shí kè	tempo
时髦	shí máo	alla moda
时期	shí qī	periodo
时尚	shí shàng	moda
石头	shí tou	calcolo
食物	shí wù	cibo
使劲儿	shǐ jìn r	difficile
始终	shǐ zhōng	sempre
事实	shì shí	fatto
事物	shì wù	cosa
事先	shì xiān	in anticipo
似的	shì de	piace
士兵	shì bīng	soldato
市场	shì chǎng	mercato
试卷	shì juàn	carta di prova
收获	shōu huò	ricompensa
收据	shōu jù	ricevuta
手工	shǒu gōng	manuale
手术	shǒu shù	chirurgia
手套	shǒu tào	guanti
手续	shǒu xù	formalità
手指	shǒu zhǐ	dito
首	shǒu	primo
受伤	shòu shāng	ferito
寿命	shòu mìng	vita
书架	shū jià	scaffale
梳子	shū zi	pettine
舒适	shū shì	confortevole
蔬菜	shū cài	verdure
输入	shū rù	accedere
熟练	shú liàn	abile
属于	shǔ yú	appartenere
数	shǔ	numero
鼠标	shǔ biāo	topo
数据	shù jù	dati
数码	shù mǎ	digitale
摔倒	shuāi dǎo	autunno
甩	shuǎi	dump
双方	shuāng fāng	entrambe le parti
税	shuì	imposta
说不定	shuō bu dìng	può essere
说服	shuō fú	convincere
丝绸	sī chóu	seta
丝毫	sī háo	minimo
思考	sī kǎo	pensiero
思想	sī xiǎng	pensiero
撕	sī	lacrima
私人	sī rén	privato
似乎	sì hū	sembrare
搜索	sōu suǒ	cercare
宿舍	sù shè	dormitorio
随身	suí shēn	trasportare
随时	suí shí	in ogni momento
随手	suí shǒu	casualmente
碎	suì	rotto
损失	sǔn shī	perdita
缩短	suō duǎn	accorciare
所	suǒ	così
锁	suǒ	serratura
台阶	tái jiē	passi
太极拳	tài jí quán	tai chi
太太	tài tai	sig.ra
谈判	tán pàn	negoziazione
坦率	tǎn shuài	franco
烫	tàng	caldo
桃	táo	pesca
淘气	táo qì	cattivo
逃	táo	fuga
逃避	táo bì	fuga
讨价还价	tǎo jià huán jià	affare
套	tào	impostato
特色	tè sè	caratteristiche
特殊	tè shū	speciale
特征	tè zhēng	caratteristica
疼爱	téng ài	amore
提倡	tí chàng	promuovere
提纲	tí gāng	contorno
提问	tí wèn	fare domande
题目	tí mù	argomento
体会	tǐ huì	esperienza
体贴	tǐ tiē	premuroso
体现	tǐ xiàn	riflettere
体验	tǐ yàn	esperienza
天空	tiān kōng	cielo
天真	tiān zhēn	ingenuo
调皮	tiáo pí	cattivo
调整	tiáo zhěng	regolazione
挑战	tiǎo zhàn	sfida
通常	tōng cháng	generalmente
统一	tǒng yī	unire
痛苦	tòng kǔ	dolore
痛快	tòng kuài	contento
偷	tōu	rubare
投入	tóu rù	investire in
投资	tóu zī	investimento
透明	tòu míng	trasparente
突出	tū chū	prominente
土地	tǔ dì	sbarcare
土豆	tǔ dòu	patata
兔子	tù zi	coniglio
吐	tù	vomitò
团	tuán	gruppo
推辞	tuī cí	declino
推广	tuī guǎng	promuovere
推荐	tuī jiàn	consiglia
退	tuì	ritiro
退步	tuì bù	regredire
退休	tuì xiū	la pensione
歪	wāi	storto
外公	wài gōng	nonno
外交	wài jiāo	diplomatico
完美	wán měi	perfetto
完善	wán shàn	perfetto
完整	wán zhěng	completare
玩具	wán jù	giocattolo
万一	wàn yī	nel caso in cui
王子	wáng zǐ	principe
往返	wǎng fǎn	andata e ritorno
网络	wǎng luò	la rete
危害	wēi hài	danno
威胁	wēi xié	minaccia
微笑	wēi xiào	sorridi
唯一	wéi yī	solo
围巾	wéi jīn	sciarpa
围绕	wéi rào	in giro
维修	wéi xiū	servizio
违反	wéi fǎn	violazione
伟大	wěi dà	grande
委屈	wěi qū	sbagliato
尾巴	wěi ba	coda
位于	wèi yú	restare in
位置	wèi zhi	posizione
未必	wèi bì	non necessariamente
未来	wèi lái	futuro
胃	wèi	stomaco
胃口	wèi kǒu	appetito
温暖	wēn nuǎn	caldo
温柔	wēn róu	tenero
文件	wén jiàn	file
文具	wén jù	stazionario
文明	wén míng	civiltà
文学	wén xué	letteratura
文字	wén zì	testo
闻	wén	odore
吻	wěn	bacio
稳定	wěn dìng	stabile
问候	wèn hòu	saluti
卧室	wò shì	camera da letto
握手	wò shǒu	stringere la mano
屋子	wū zi	camera
无奈	wú nài	impotente
无数	wú shù	innumerevoli
无所谓	wú suǒ wèi	non importa
武术	wǔ shù	arti marziali
勿	wù	non
物理	wù lǐ	fisico
物质	wù zhì	sostanza
雾	wù	nebbia
吸取	xī qǔ	disegnare
吸收	xī shōu	assorbire
戏剧	xì jù	dramma
系	xì	sistema
系统	xì tǒng	sistema
细节	xì jié	dettaglio
瞎	xiā	cieco
下载	xià zǎi	scarica
吓	xià	spavento
夏令营	xià lìng yíng	campo estivo
鲜艳	xiān yàn	luminoso
显得	xiǎn de	apparire
显然	xiǎn rán	ovviamente
显示	xiǎn shì	schermo
县	xiàn	contea
现代	xiàn dài	moderno
现实	xiàn shí	la realtà
现象	xiàn xiàng	fenomeno
限制	xiàn zhì	limite
相处	xiāng chǔ	andare d'accordo
相当	xiāng dāng	abbastanza
相对	xiāng duì	relativamente
相关	xiāng guān	relazionato
相似	xiāng sì	simile
香肠	xiāng cháng	salsiccia
享受	xiǎng shòu	godere
想念	xiǎng niàn	perdere
想象	xiǎng xiàng	immaginare
象棋	xiàng qí	scacchi
象征	xiàng zhēng	simbolo
项	xiàng	articolo
项链	xiàng liàn	collana
项目	xiàng mù	progetto
消费	xiāo fèi	consumo
消化	xiāo huà	digestione
消极	xiāo jí	negativo
消失	xiāo shī	scomparire
销售	xiāo shòu	i saldi
小麦	xiǎo mài	grano
小气	xiǎo qi	avaro
孝顺	xiào shun	pietà filiale
效率	xiào lv4	efficacia
歇	xiē	riposo
斜	xié	obliquo
写作	xiě zuò	la scrittura
心理	xīn lǐ	psicologico
心脏	xīn zàng	cuore
欣赏	xīn shǎng	godere
信号	xìn hào	segnale
信任	xìn rèn	fiducia
形成	xíng chéng	modulo
形容	xíng róng	descrivere
形势	xíng shì	situazione
形式	xíng shì	modulo
形象	xíng xiàng	immagine
形状	xíng zhuàng	forma
行动	xíng dòng	azione
行人	xíng rén	pedone
行为	xíng wéi	comportamento
幸亏	xìng kuī	fortunatamente
幸运	xìng yùn	fortunato
性质	xìng zhì	natura
兄弟	xiōng dì	fratelli
胸	xiōng	il petto
休闲	xiū xián	casuale
修改	xiū gǎi	modificare
虚心	xū xīn	modesto
叙述	xù shù	narrate
宣布	xuān bù	annunciare
宣传	xuān chuán	pubblicità
学历	xué lì	formazione scolastica
学术	xué shù	accademico
学问	xué wèn	conoscenza
血	xuè	sangue
寻找	xún zhǎo	ricerca
询问	xún wèn	chiedi
训练	xùn liàn	formazione
迅速	xùn sù	rapido
押金	yā jīn	depositare
牙齿	yá chǐ	dente
严肃	yán sù	grave
延长	yán cháng	estendere
演讲	yǎn jiǎng	discorso
宴会	yàn huì	banchetto
阳台	yáng tái	balcone
痒	yǎng	prurito
样式	yàng shì	stile
腰	yāo	vita
摇	yáo	scuotere
咬	yǎo	mordere
要不	yào bù	o
业务	yè wù	attività commerciale
业余	yè yú	dilettante
夜	yè	notte
依然	yī rán	ancora
一辈子	yí bèi zi	tutta la vita
一旦	yí dàn	una volta
一律	yí lv4	sempre
一再	yí zài	ripetutamente
一致	yí zhì	coerente
疑问	yí wèn	dubbio
移动	yí dòng	mobile
移民	yí mín	immigrazione
遗憾	yí hàn	rimpiangere
乙	yǐ	b
以及	yǐ jí	così come
以来	yǐ lái	da
义务	yì wù	obbligo
亿	yì	miliardi
意外	yì wài	incidente
意义	yì yì	significato
议论	yì lùn	parlare
因而	yīn ér	così
因素	yīn sù	fattore
银	yín	argento
印刷	yìn shuā	stampa
英俊	yīng jùn	di bell'aspetto
英雄	yīng xióng	eroe
营养	yíng yǎng	nutrizione
营业	yíng yè	attività commerciale
迎接	yíng jiē	incontrare
影子	yǐng zi	ombra
应付	yìng fu	maniglia
应用	yìng yòng	applicazione
硬	yìng	difficile
硬件	yìng jiàn	hardware
拥抱	yōng bào	abbraccio
拥挤	yōng jǐ	affollato
勇气	yǒng qì	coraggio
用功	yòng gōng	lavorare duramente
用途	yòng tú	uso
优惠	yōu huì	sconto
优美	yōu měi	bellissimo
优势	yōu shì	vantaggio
悠久	yōu jiǔ	lungo
油炸	yóu zhá	fritto
游览	yóu lǎn	tour
犹豫	yóu yù	esita
有利	yǒu lì	favorevole
幼儿园	yòu ér yuán	asilo
娱乐	yú lè	divertimento
与其	yǔ qí	invece di
语气	yǔ qì	tono
玉米	yù mǐ	mais
预报	yù bào	previsione
预订	yù dìng	prenotazione
预防	yù fáng	prevenzione
元旦	yuán dàn	capodanno
原料	yuán liào	materiale grezzo
原则	yuán zé	in linea di principio
员工	yuán gōng	dipendente
圆	yuán	il giro
愿望	yuàn wàng	desiderio
乐器	yuè qì	strumento musicale
晕	yūn	perbacco
运气	yùn qi	fortuna
运输	yùn shū	trasporto
运用	yùn yòng	uso
灾害	zāi hài	disastro
再三	zài sān	ripetutamente
在乎	zài hu	cura
在于	zài yú	si trova in
赞成	zàn chéng	essere d'accordo
赞美	zàn měi	lode
糟糕	zāo gāo	cattivo
造成	zào chéng	causa
则	zé	poi
责备	zé bèi	colpa
摘	zhāi	scegli
窄	zhǎi	stretto
粘贴	zhān tiē	incolla
展开	zhǎn kāi	svelare
展览	zhǎn lǎn	mostra
占	zhàn	occupare
战争	zhàn zhēng	guerra
掌握	zhǎng wò	afferrare
涨	zhǎng	aumento
长辈	zhǎng bèi	sambuco
账户	zhàng hù	account
招待	zhāo dài	intrattenere
着火	zháo huǒ	a fuoco
着凉	zháo liáng	prendere freddo
召开	zhào kāi	aspetta
照常	zhào cháng	come di solito
哲学	zhé xué	filosofia
珍惜	zhēn xī	cherish
真实	zhēn shí	vero
针对	zhēn duì	contro
诊断	zhěn duàn	diagnosi
振动	zhèn dòng	vibrazione
阵	zhèn	vettore
争论	zhēng lùn	discussione
争取	zhēng qǔ	lottare per
征求	zhēng qiú	cercare
挣	zhēng	guadagnare
睁	zhēng	apri gli occhi
整个	zhěng gè	intero
整齐	zhěng qí	pulito
整体	zhěng tǐ	complessivamente
政府	zhèng fǔ	governo
政治	zhèng zhì	politico
正	zhèng	positivo
证件	zhèng jiàn	certificato
证据	zhèng jù	prova
支	zhī	supporto
支票	zhī piào	dai un'occhiata
执照	zhí zhào	licenza
直	zhí	dritto
指导	zhǐ dǎo	guida
指挥	zhǐ huī	comando
制定	zhì dìng	rendere
制度	zhì dù	sistema
制造	zhì zào	produzione
制作	zhì zuò	rendere
志愿者	zhì yuàn zhě	volontario
智慧	zhì huì	saggezza
治疗	zhì liáo	trattamento
秩序	zhì xù	ordine
至今	zhì jīn	ad oggi
至于	zhì yú	quanto a
中介	zhōng jiè	procacciatore d'affari
中心	zhōng xīn	centro
中旬	zhōng xún	a medio termine
种类	zhǒng lèi	specie
重大	zhòng dà	maggiore
重量	zhòng liàng	peso
周到	zhōu dao	premuroso
猪	zhū	maiale
竹子	zhú zi	bambù
逐步	zhú bù	passo dopo passo
逐渐	zhú jiàn	gradualmente
主持	zhǔ chí	ospite
主动	zhǔ dòng	iniziativa
主观	zhǔ guān	soggettivo
主人	zhǔ rén	il padrone di casa
主任	zhǔ rèn	direttore
主题	zhǔ tí	tema
主席	zhǔ xí	presidente
主张	zhǔ zhāng	richiesta
煮	zhǔ	cucinare
注册	zhù cè	registrato
祝福	zhù fú	benedizione
抓	zhuā	afferrare
抓紧	zhuā jǐn	presta molta attenzione
专家	zhuān jiā	esperto
专心	zhuān xīn	concentrarsi
转变	zhuǎn biàn	modificare
转告	zhuǎn gào	raccontare
装	zhuāng	installare
装饰	zhuāng shì	decorazione
装修	zhuāng xiū	decorazione
撞	zhuàng	colpire
状况	zhuàng kuàng	situazione
状态	zhuàng tài	stato
追	zhuī	inseguire
追求	zhuī qiú	perseguire
咨询	zī xún	consultivo
姿势	zī shì	postura
资格	zī gé	titoli di studio
资金	zī jīn	fondi
资料	zī liào	dati
资源	zī yuán	risorse
紫	zǐ	viola
字母	zì mǔ	lettera
字幕	zì mù	sottotitolo
自从	zì cóng	da
自动	zì dòng	automatico
自豪	zì háo	orgoglio
自觉	zì jué	cosciente
自私	zì sī	egoista
自由	zì yóu	gratuito
自愿	zì yuàn	volontario
综合	zōng hé	completo
总裁	zǒng cái	presidente
总共	zǒng gòng	in totale
总理	zǒng lǐ	primo ministro
总算	zǒng suàn	infine
总统	zǒng tǒng	presidente
总之	zǒng zhī	in breve
组	zǔ	gruppo
组成	zǔ chéng	composizione
组合	zǔ hé	combinazione
组织	zǔ zhī	organizzazione
阻止	zǔ zhǐ	impedire
最初	zuì chū	iniziale
醉	zuì	ubriaco
尊敬	zūn jìng	rispetto
遵守	zūn shǒu	attenersi a
作品	zuò pǐn	lavori
作为	zuò wéi	come
作文	zuò wén	composizione
