啊	a	(int.) solía expresar sorpresa; exclamación o promesa
阿姨	ā yí	(n.) tía; mujer de mediana edad; empleada doméstica; doméstica expresar exclamación, duda o; expresar exclamación, duda o
矮	ǎi	(adj.) bajo
爱好	ài hào	(n.) afición; (v.) aficionarse; sentir interés por
安静	ān jìng	(adj.) tranquilo; (v.) quedar sin voces ni ruido; (prep.) locución preposicional para anteponer el
把	bǎ	complemento del verbo; (cn.) clasificador para objetos con asa
搬	bān	(v.) mover
班	bān	(n.) grupo
办法	bàn fǎ	(n.) método; manera de hacer algo
办公室	bàn gōng shì	(n.) oficina
半	bàn	(num.) medio
帮忙	bāng máng	(v.) ayudar
包	bāo	(n.) bolsa
饱	bǎo	(adj.) saciado; sentirse lleno
北方	běi fāng	(n.) norte
被	bèi	(prep.) indicativo de la voz pasiva
鼻子	bí zi	(n.) nariz
比较	bǐ jiào	(adv.) bastante; relativamente
比赛	bǐ sài	(n.) competición; (v.) competir
笔记本	bǐ jì běn	(n.) libreta, cuaderno; (n.) ordenador (computador) portátil
必须	bì xū	(adv.) hay que; tener que
变化	biàn huà	(n.) cambio; variación; (v.) cambiar; variar
别人	bié rén	(pron.) otros; otras personas
冰箱	bīng xiāng	(n.) refrigerador; frigorífico
不但…而且…	bù dàn …ér qiě …	(conj.) además; no solo… sino también…
菜单	cài dān	(n.) menú
参加	cān jiā	(v.) asistir; tomar parte en
草	cǎo	(n.) hierba
层	céng	(cn.) piso
差	chà	(adj.) malo; (v.) falta
超市	chāo shì	(n.) supermercado
衬衫	chèn shān	(n.) camisa
城市	chéng shì	(n.) ciudad
成绩	chéng jì	(n.) nota; puntuación; resultado
迟到	chí dào	(v.) llegar tarde
除了	chú le	(prep.) excepto; menos
船	chuán	(n.) barco
春	chūn	(n.) primavera
词典	cí diǎn	(n.) diccionario
聪明	cōng ming	(adj.) inteligente
打扫	dǎ sǎo	(v.) limpiar
打算	dǎ suàn	(v.) querer; planear, proponerse; (n.) plan
带	dài	(v.) llevarse
担心	dān xīn	(v.) preocuparse; estar preocupado
蛋糕	dàn gāo	(n.) pastel
当然	dāng rán	(adv..) claro; naturalmente
地	de	(ae.) indicativo de un adverbio
灯	dēng	(n.) lámpara, luz
地方	dì fang	(n.) lugar
地铁	dì tiě	(n.) metro
地图	dì tú	(n.) mapa
电梯	diàn tī	(n.) ascensor; elevador
电子邮件	diàn zǐ yóu jiàn	(n.) correo electrónico; email
东	dōng	(n.) este
冬	dōng	(n.) invierno
动物	dòng wù	(n.) animal
短	duǎn	(adj.) corto
段	duàn	(cn.) segmento de tiempo, distancia o texto
锻炼	duàn liàn	(v.) hacer ejercicios para la salud
多么	duō me	(adv.) ¡qué+ adj.! (exclamación)
饿	è a	(adj.) hambre
耳朵	ěr duo	(n.) oreja
发	fā	(v.) enviar
发烧	fā shāo	(v.) tener fiebre
发现	fā xiàn	(v.) notar; descubrir
方便	fāng biàn	(adj.) conveniente; cómodo
放	fàng	(v.) poner
放心	fàng xīn	(v.) ¡Descuida!; !tranquilo!; (num.) minuto
分	fēn	(n.) puntuación; nota; (v.) separar
复习	fù xí	(v.) repasar
附近	fù jìn	(n.) lugar próximo; proximidad
干净	gān jìng	(adj.) limpio
感冒	gǎn mào	(v.) resfriado; catarro
感兴趣	gǎn xìng qù	interesarse por
刚才	gāng cái	(n.) recién; recientemente
个子	gè zi	(n.) estatura
根据	gēn jù	(prep.) de acuerdo con; (n.) fundamento; razón
跟	gēn	(v.) seguir; (prep.) con
更	gèng	(adv.) más
公斤	gōng jīn	(cn.) kilogramo (kg)
公园	gōng yuán	(n.) parque
故事	gù shi	(n.) cuento; historia
刮风	guā fēng	hacer viento
关	guān	(v.) cerrar; apagar
关系	guān xì	(n.) relación
关心	guān xīn	(v.) cuidar; (n.) preocupación; consideración
关于	guān yú	(prep.) en cuanto a
国家	guó jiā	(n.) país
过	guò	(aux.) usado despué de un verbo para referirse a una acción terminada; referirse a una acción terminada
过去	guò qu	(n.) en el pasado; del pasado; (adv.) todaví
还是	hái shì	(adv.) es mejor (para una sugerencia); (adv.) o
害怕	hài pà	(v.) tener miedo
黑板	hēi bǎn	(n.) pizarra
后来	hòu lái	(adv.) más tarde; despué
护照	hù zhào	(n.) pasaporte
花	huā	(v.) gastar; (n.) flor
花	huā	(v.) gastar; (n.) flor
画	huà	(v.) dibujar; (n.) pintura; dibujo
坏	huài	(adj.) malo; malogrado, hecho a perder; (int.) caramba; fatal
欢迎	huān yíng	(v.) bienvenido
环境	huán jìng	(n.) medio ambiente
还	huán	(adv.) todaví; (adv.) además
换	huàn	(v.) cambiarse; (v.) cambiar dinero
黄河	huáng hé	(n.) Río Amarillo
回答	huí dá	(v.) contestar; responder; (n.) respuesta
会议	huì yì	(n.) reunión
或者	huò zhě	(conj.) o
几乎	jī hū	(adv.) casi
机会	jī huì	(n.) oportunidad
极	jí	(adv.) sumamente; extremadamente
季节	jì jié	(n.) estación
记得	jì de	(v.) recordar
检查	jiǎn chá	(v.) inspeccionar; chequear
简单	jiǎn dān	(adj.) fácil; simple
健康	jiàn kāng	(adj.) sano; tener buena salud
见面	jiàn miàn	(v.) encontrarse con
讲	jiǎng	(v.) hablar
教	jiào	(v.) enseñar
脚	jiǎo	(n.) pie
角	jiǎo	(cn.) diez céntimos de un RMB, Yuan; (n.) rincón
接	jiē	(v.) recibir; aceptar; (v.) seguir
街道	jiē dào	(n.) calle
结婚	jié hūn	(v.) casarse
结束	jié shù	(v.) terminar
节目	jié mù	(n.) programa; número
节日	jié rì	(n.) día de fiesta
解决	jiě jué	(v.) resolver un problema
借	jiè	(v.) pedir prestado
经常	jīng cháng	(adv.) a menudo
经过	jīng guò	(v.) pasar por; (prep.) por
经理	jīng lǐ	(n.) gerente
久	jiǔ	(adj.) por largo tiempo
旧	jiù	(adj.) viejo; desgastado
句子	jù zi	(n.) oración
决定	jué dìng	(v.) decidir; determinar; (n.) decisión; resolución
可爱	kě ài	(adj.) mono; guapo; simpático
渴	kě	(adj.) sed
刻	kè	(n.) cuarto de hora; 15 minutos
客人	kè rén	(n.) invitado
空调	kōng tiáo	(n.) aire acondicionado; (cn.) clasificador para hombres o algunos
口	kǒu	animales; (n.) boca
哭	kū	(v.) llorar
裤子	kù zi	(n.) pantalones
筷子	kuài zi	(n.) palillos (para comer)
蓝	lán	(adj.) azul
老	lǎo	(adj.) viejo
离开	lí kāi	(v.) salir de; separarse de
礼物	lǐ wù	(n.) regalo
历史	lì shǐ	(n.) historia
脸	liǎn	(n.) cara
练习	liàn xí	(v.) práctica; (n.) ejercicio
辆	liàng	(cn.) clasificador para vehículos
聊天	liáo tiān	(vs.) charlar
了解	liǎo jiě	(v.) conocer; entender
邻居	lín jū	(n.) vecino
留学	liú xué	(v.) estudiar en el extranjero
楼	lóu	(n.) edificio
绿	lv4	(adj.) verde
马	mǎ	(n.) caballo
马上	mǎ shàng	(adv.) inmediatamente; en seguida
满意	mǎn yì	(v.) estar satisfecho
帽子	mào zi	(n.) gorra
米	mǐ	(cn.) metro (unidad de longitud)
面包	miàn bāo	(n.) pan
明白	míng bai	(v.) entender; comprender; (adj.) claro; explícito
拿	ná	(v.) tomar; sostener
奶奶	nǎi nai	(n.) abuela (paterna)
南	nán	(n.) sur
难	nán	(adj.) difícil
难过	nán guò	(v.) afligirse
年级	nián jí	(n.) curso; año
年轻	nián qīng	(adj.) joven
鸟	niǎo	(n.) pájaro
努力	nǔ lì	(adj.) con aplicación
爬山	pá shān	(v.) escalar la montaña
盘子	pán zi	(n.) plato
胖	pàng	(adj) gordo; (v.) engordar
啤酒	pí jiǔ	(n.) cerveza
皮鞋	pí xié	(n.) zapato de piel
瓶子	píng zi	(n.) botella
其实	qí shí	(adv.) en realidad; de hecho
其他	qí tā	(pron.) los demás
奇怪	qí guài	(adj.) raro; extraño
骑	qí	(v.) montar (en bicicleta etc.)
起飞	qǐ fēi	(v.) despegar (un avión)
起来	qǐ lái	(v.) usado despué de un verbo para indicar dirección o tendencia; dirección o tendencia
清楚	qīng chu	(adj.) claro; con claridad; (v.) entender; comprender
请假	qǐng jià	(vs.) pedir permiso para ausentarse en el trabajo, estudio; trabajo, estudio
秋	qiū	(n.) otoño
裙子	qún zi	(n.) falda
然后	rán hòu	(conj.) despué
热情	rè qíng	(adj.) fervor; entusiasmo, efusivo
认为	rèn wéi	(v.) creer
认真	rèn zhēn	(adj.) concienzudo
容易	róng yì	(adj.) fácil
如果	rú guǒ	(conj.) si; en caso de
伞	sǎn	(n.) paraguas; sombrilla
上网	shàng wǎng	(v.) acceder a Internet
声音	shēng yīn	(n.) sonido; ruido
生气	shēng qì	(v.) enojarse
世界	shì jiè	(n.) mundo
试	shì	(v.) probar
瘦	shòu	(adj.) delgado; (v.) adelgazar
叔叔	shū shu	(n.) tío (paterno)
舒服	shū fu	(adj.) cómodo; confortable
数学	shù xué	(n.) matemáticas
树	shù	(n.) árbol
刷牙	shuā yá	(v.) cepillarse los dientes
双	shuāng	(cn.) par
水平	shuǐ píng	(n.) nivel
司机	sī jī	(n.) conductor
太阳	tài yáng	(n.) sol
特别	tè bié	(adv.) muy; particularmente; (adj) especial; extraordinario
疼	téng	(v.) dolor, doloroso, dolorido
提高	tí gāo	(v.) elevar; (n.) elevación; incremento
体育	tǐ yù	(n.) deporte
甜	tián	(adj.) dulce
条	tiáo	(cn.) clasificador para objetos largos y delgados; delgados
同事	tóng shì	(n.) colega
同意	tóng yì	(v.) de acuerdo; conforme
头发	tóu fa	(n.) cabello
突然	tū rán	(adj.) de repente; pronto; (adv.) súbitamente; inesperadamente
图书馆	tú shū guǎn	(n.) biblioteca
腿	tuǐ	(n.) pierna
完成	wán chéng	(v.) terminar; cumplir
碗	wǎn	(n.) tazón; (cn.) un tazón de
万	wàn	(num.) diez mil
忘记	wàng jì	(v.) olvidar; olvidarse
为	wèi	(prep.) para
为了	wèi le	(prep.) para; por
位	wèi	(cn.) calsificador para personas
文化	wén huà	(n.) cultura
西	xī	(n.) oeste
习惯	xí guàn	(v.) costumbre; (n.) hábito; práctica usual
洗手间	xǐ shǒu jiān	(n.) baño; servicio; retrete; cuarto de aseo
洗澡	xǐ zǎo	(v.) bañarse; ducharse
夏	xià	(n.) verano
先	xiān	(adv.) primero
相信	xiāng xìn	(v.) creer en; tener confianza en
香蕉	xiāng jiāo	(n.) banana, plátano
像	xiàng	(v.) parecerse; (prep.) por ejemplo; como
向	xiàng	(prep.) a; hacia
小心	xiǎo xīn	(v.) ¡cuidado!; tener cuidado; (adj.) cuidadoso
校长	xiào zhǎng	(n.) director (de colegio); rector
新闻	xīn wén	(n.) noticia
新鲜	xīn xiān	(adj.) fresco
信用卡	xìn yòng kǎ	(n.) carta de crédito
行李箱	xíng lǐ xiāng	(n.) maleta
熊猫	xióng māo	(n.) oso panda
需要	xū yào	(v.) necesitar
选择	xuǎn zé	(v.) elegir; escoger; (n.) selección; opción
要求	yāo qiú	(v.) exigir; pedir; (n.) exigencia
爷爷	yé ye	(n.) abuelo (paterno)
一直	yī zhí	(adv.) desde hace tiempo
一定	yí dìng	(adv.) sin falta; (adj) cierto
一共	yī gòng	(adv.) en total
一会儿	yī huì er	muy corto tiempo
一样	yī yàng	(adj.) lo mismo
以前	yǐ qián	(adv.) antes de;
一般	yī bān	(adv.) generalmente; regularmente
一边	yī biān	(adv.) mientras; al mismo tiempo
音乐	yīn yuè	(n.) música
银行	yín háng	(n.) banco
饮料	yǐn liào	(n.) bebida
应该	yīng gāi	(va.) tener que; deber
影响	yǐng xiǎng	(v.) afectar; (n.) influencia; efecto
用	yòng	(v.) uso
游戏	yóu xì	(n.) juego; recreación
有名	yǒu míng	(adj.) famoso
又	yòu	(adv.) una vez más; volver a; de nuevo
遇到	yù dào	(v.) encontrarse con
元	yuán	(cn.) RMB, Yuan
愿意	yuàn yì	(va.) estar dispuesto a; querer
月亮	yuè liang	(n.) luna
越	yuè	(adv.) cuanto más…más…
站	zhàn	(v.) estar parado; (cn.) parada; (cn.) clasificador para papel, cama, mesa,
张	zhāng	boca, cara, etc.; (v.) abrir
长	zhǎng	(adj.) largo
着急	zháo jí	(v.) preocupado; inquieto
照顾	zhào gu	(v.) cuidar; (n.) cuido; solicitud; cuidado
照片	zhào piàn	(n.) foto
照相机	zhào xiàng jī	(n.) cámara
只	zhǐ	(cn.) clasificador para animales u objetos; cada uno del par; cada uno del par; (adv.) sólo
只	zhǐ	(cn.) clasificador para animales u objetos; cada uno del par; cada uno del par; (adv.) sólo
只有…才…	zhǐ yǒu …cái …	solo si… entonces…
中间	zhōng jiān	(n.) centro; medio
中文	zhōng wén	(n.) chino (lengua)
终于	zhōng yú	(adv.) por fin; finalmente
种	zhǒng	(cn.) tipo; variedad
重要	zhòng yào	(adj.) importante
周末	zhōu mò	(n.) fin de semana
主要	zhǔ yào	(adj.) principal; lo principal
注意	zhù yì	(v.) prestar atención
自己	zì jǐ	(pron.) hacer algo valiéndose de símismo
自行车	zì xíng chē	(n.) bicicleta
总是	zǒng shì	(adv.) siempre
嘴	zuǐ	(n.) boca
最后	zuì hòu	(n.) el último; (adv.) finalmente
最近	zuì jìn	(adv.) últimamente; recientemente
作业	zuò yè	(n.) deberes
