哎	āi	ei
唉	āi	ugh
爱护	ài hù	prezar
爱惜	ài xī	prezar
爱心	ài xīn	ame
安慰	ān wèi	conforto
安装	ān zhuāng	instalação
岸	àn	costa
暗	àn	sombrio
熬夜	áo yè	ficar acordado até tarde
把握	bǎ wò	aperto
摆	bǎi	colocar
办理	bàn lǐ	lidar com
傍晚	bàng wǎn	tarde
包裹	bāo guǒ	pacote
包含	bāo hán	conter
包括	bāo kuò	incluir
薄	báo	fino
保持	bǎo chí	manter
保存	bǎo cún	salve 
保留	bǎo liú	manter
保险	bǎo xiǎn	seguro
宝贝	bǎo bèi	bebê
宝贵	bǎo guì	valioso
报到	bào dào	check-in
报道	bào dào	relatório
报告	bào gào	relatório
报社	bào shè	jornal
抱怨	bào yuàn	reclamar
悲观	bēi guān	pessimista
背	bèi	costas
背景	bèi jǐng	fundo
被子	bèi zi	colcha
本科	běn kē	estudante universitário
本领	běn lǐng	habilidade
本质	běn zhì	natureza
彼此	bǐ cǐ	entre si
比例	bǐ lì	proporção
必然	bì rán	inevitável
必要	bì yào	necessário
毕竟	bì jìng	depois de tudo
避免	bì miǎn	evitar
编辑	biān jí	editar
鞭炮	biān pào	foguete
便	biàn	cocô
辩论	biàn lùn	debate
标点	biāo diǎn	pontuação
标志	biāo zhì	placa
表达	biǎo dá	expressão
表面	biǎo miàn	superfície
表明	biǎo míng	mostrar
表情	biǎo qíng	expressão
表现	biǎo xiàn	que executou
冰激凌	bīng jī líng	sorvete
病毒	bìng dú	vírus
播放	bō fàng	jogar
玻璃	bō li	vidro
博物馆	bó wù guǎn	museu
脖子	bó zi	pescoço
不断	bú duàn	continuar
不见得	bú jiàn de	não necessariamente
不耐烦	bú nài fán	impaciente
不要紧	bú yào jǐn	não importa
补充	bǔ chōng	suplemento
不安	bù ān	perturbado
不得了	bù dé liǎo	terrível
不然	bù rán	de outra forma
不如	bù rú	não tão bom quanto
不足	bù zú	insuficiente
布	bù	pano
步骤	bù zhòu	degrau
部门	bù mén	departamento
财产	cái chǎn	propriedade
彩虹	cǎi hóng	arco iris
踩	cǎi	pise
采访	cǎi fǎng	entrevista
采取	cǎi qǔ	toma
参考	cān kǎo	referência
参与	cān yù	participar
惭愧	cán kuì	envergonhado
操场	cāo chǎng	parque infantil
操心	cāo xīn	preocupação
册	cè	livro
测验	cè yàn	teste
曾经	céng jīng	uma vez
叉子	chā zi	garfo
差距	chā jù	gap = vão
插	chā	inserir
拆	chāi	desmantelar
产品	chǎn pǐn	produtos
产生	chǎn shēng	produzir
常识	cháng shí	senso comum
长途	cháng tú	longa distância
抄	chāo	cópia de
超级	chāo jí	super
朝	cháo	em direção
潮湿	cháo shī	molhado
吵	chǎo	barulhento
吵架	chǎo jià	briga
炒	chǎo	fritar
车库	chē kù	garagem
车厢	chē xiāng	carro
彻底	chè dǐ	completo
沉默	chén mò	silêncio
趁	chèn	tirar proveito de
称	chēng	pesar
称呼	chēng hu	ligar
称赞	chēng zàn	elogio
成分	chéng fèn	ingrediente
成果	chéng guǒ	resultados
成就	chéng jiù	realização
成立	chéng lì	estabelecido
成人	chéng rén	adulto
成熟	chéng shú	maduro
成语	chéng yǔ	idioma
成长	chéng zhǎng	crescendo
承担	chéng dān	urso
承认	chéng rèn	reconhecimento
承受	chéng shòu	urso
程度	chéng dù	grau
程序	chéng xù	programa
诚恳	chéng kěn	sincero
吃亏	chī kuī	sofra
持续	chí xù	contínuo
池塘	chí táng	lagoa
迟早	chí zǎo	cedo ou tarde
尺子	chǐ zi	régua
翅膀	chì bǎng	asa
充电器	chōng diàn qì	carregador
充分	chōng fèn	cheio
充满	chōng mǎn	cheio
冲	chōng	pressa
重复	chóng fù	repetir
宠物	chǒng wù	animal
抽屉	chōu ti	gaveta
抽象	chōu xiàng	abstrato
丑	chǒu	feio
臭	chòu	malcheiroso
出版	chū bǎn	publicação
出口	chū kǒu	exportar
出色	chū sè	excepcional
出示	chū shì	mostrar
出席	chū xí	comparecer
初级	chū jí	primário
除非	chú fēi	a menos que
除夕	chú xī	véspera de ano novo
处理	chǔ lǐ	lide com
传播	chuán bō	propagação
传染	chuán rǎn	infecção
传说	chuán shuō	lenda
传统	chuán tǒng	tradicional
窗帘	chuāng lián	cortina
闯	chuǎng	pressa
创造	chuàng zào	crio
吹	chuī	golpe
词汇	cí huì	vocabulário
辞职	cí zhí	renúncia
此外	cǐ wài	além do que, além do mais
刺激	cì jī	estimular
次要	cì yào	secundário
匆忙	cōng máng	pressa
从此	cóng cǐ	desde então
从而	cóng ér	assim
从前	cóng qián	antes
从事	cóng shì	se envolver no
粗糙	cū cāo	rude
促进	cù jìn	promover
促使	cù shǐ	pronto
醋	cù	vinagre
催	cuī	lembrar
存在	cún zài	existir
措施	cuò shī	medidas
答应	dā ying	promessa
达到	dá dào	alcançar
打工	dǎ gōng	trabalho em meio período
打交道	dǎ jiāo dào	lide com
打喷嚏	dǎ pēn tì	espirrar
打听	dǎ ting	questionar sobre
大方	dà fāng	generoso
大厦	dà shà	construção
大象	dà xiàng	elefante
大型	dà xíng	ampla
呆	dāi	fique
代表	dài biǎo	representante
代替	dài tì	em vez de
待遇	dài yù	tratamento
贷款	dài kuǎn	empréstimo
单纯	dān chún	simples
单调	dān diào	monótono
单独	dān dú	sozinho
单位	dān wèi	unidade
单元	dān yuán	unidade
担任	dān rèn	servir como
耽误	dān wu	aguarde
胆小鬼	dǎn xiǎo guǐ	covarde
淡	dàn	luz
当地	dāng dì	local
当心	dāng xīn	cuidado
挡	dǎng	quadra
倒霉	dǎo méi	azarado
导演	dǎo yǎn	diretor
导致	dǎo zhì	resultando em
岛屿	dǎo yǔ	ilhas
到达	dào dá	chegadas
道德	dào dé	moral
道理	dào lǐ	razão
登记	dēng jì	registro
等待	děng dài	esperar
等于	děng yú	igual
滴	dī	solta
敌人	dí rén	inimigo
的确	dí què	de fato
地道	dì dao	típica
地理	dì lǐ	geografia
地区	dì qū	área
地毯	dì tǎn	tapete
地位	dì wèi	status
地震	dì zhèn	tremor de terra
递	dì	passar
点心	diǎn xin	sobremesa
电池	diàn chí	bateria
电台	diàn tái	estação de rádio
钓	diào	pescaria
顶	dǐng	topo
冻	dòng	congelar
动画片	dòng huà piān	desenho animado
洞	dòng	orifício
豆腐	dòu fu	tofu
逗	dòu	provocação
独立	dú lì	independente
独特	dú tè	único
度过	dù guò	gastar
断	duàn	quebrar
堆	duī	amontoar
兑换	duì huàn	troca
对比	duì bǐ	comparado
对待	duì dài	tratar
对方	duì fāng	outro lado
对手	duì shǒu	oponente
对象	duì xiàng	objeto
吨	dūn	tonelada
蹲	dūn	agachamento
顿	dùn	pausa
多亏	duō kuī	obrigado
多余	duō yú	redundante
朵	duǒ	faz
躲藏	duǒ cáng	ocultar
恶劣	è liè	mau
耳环	ěr huán	brinco
发表	fā biǎo	publicar
发愁	fā chóu	preocupação
发达	fā dá	desenvolvido
发抖	fā dǒu	tremendo
发挥	fā huī	jogar
发明	fā míng	invenção
发票	fā piào	fatura
发言	fā yán	falar
罚款	fá kuǎn	bem
法院	fǎ yuàn	quadra
翻	fān	virar
繁荣	fán róng	prosperidade
反而	fǎn ér	em vez de
反复	fǎn fù	repetidamente
反应	fǎn yìng	reação
反映	fǎn yìng	refletir
反正	fǎn zhèng	de qualquer forma
范围	fàn wéi	alcance
方	fāng	quadrado
方案	fāng àn	programa
方式	fāng shì	o caminho
妨碍	fáng ài	dificultar
仿佛	fǎng fú	até parece
非	fēi	não-
肥皂	féi zào	sabão em barra
废话	fèi huà	absurdo
分别	fēn bié	respectivamente
分布	fēn bù	distribuído
分配	fēn pèi	distribuição
分手	fēn shǒu	rompimento
分析	fēn xī	análise
纷纷	fēn fēn	um após o outro
奋斗	fèn dòu	luta
疯狂	fēng kuáng	louco
风格	fēng gé	estilo
风景	fēng jǐng	panorama
风俗	fēng sú	personalizadas
风险	fēng xiǎn	risco
讽刺	fěng cì	ironia
否定	fǒu dìng	negativo
否认	fǒu rèn	negar
幅	fú	largura
扶	fú	socorro
服装	fú zhuāng	roupas
辅导	fǔ dǎo	coaching
复制	fù zhì	cópia de
妇女	fù nv3	mulheres
改革	gǎi gé	reforma
改进	gǎi jìn	melhorar
改善	gǎi shàn	melhorar
改正	gǎi zhèng	corrigir
概括	gài kuò	generalizar
概念	gài niàn	conceito
盖	gài	cobrir
干脆	gān cuì	simplesmente
干燥	gān zào	seco
感激	gǎn jī	grato
感受	gǎn shòu	sentir
感想	gǎn xiǎng	pensamentos
赶紧	gǎn jǐn	se apresse
赶快	gǎn kuài	se apresse
干活儿	gàn huó r	trabalhos
钢铁	gāng tiě	aço
高档	gāo dàng	de luxo
高级	gāo jí	avançado
搞	gǎo	se envolver no
告别	gào bié	despedir-se
格外	gé wài	particularmente
隔壁	gé bì	próxima porta
个别	gè bié	individual
个人	gè rén	pessoal
个性	gè xìng	personalidade
各自	gè zì	respectivo
根	gēn	raiz
根本	gēn běn	fundamental
公布	gōng bù	anunciar
公开	gōng kāi	público
公平	gōng píng	justo
公寓	gōng yù	apartamento
公元	gōng yuán	de anúncios.
公主	gōng zhǔ	princesa
功能	gōng néng	características
工厂	gōng chǎng	fábrica
工程师	gōng chéng shī	engenheiro
工具	gōng jù	ferramenta
工人	gōng rén	trabalhador
工业	gōng yè	indústria
恭喜	gōng xǐ	parabéns
贡献	gòng xiàn	contribuição
沟通	gōu tōng	comunicação
构成	gòu chéng	constituir
姑姑	gū gu	tia
姑娘	gū niang	menina
古代	gǔ dài	antigo
古典	gǔ diǎn	clássico
股票	gǔ piào	estoque
骨头	gǔ tou	osso
鼓舞	gǔ wǔ	inspirar
鼓掌	gǔ zhǎng	aplaudir
固定	gù dìng	fixo
挂号	guà hào	registrado
乖	guāi	seja bom
拐弯	guǎi wān	virar
怪不得	guài bu de	não admira
关闭	guān bì	desligar
官	guān	oficial
观察	guān chá	observado
观点	guān diǎn	visão
观念	guān niàn	idéia
管子	guǎn zǐ	tubo
冠军	guàn jūn	campeão
光滑	guāng hua	suave
光临	guāng lín	venha
光明	guāng míng	brilhante
光盘	guāng pán	cd
广场	guǎng chǎng	quadrado
广大	guǎng dà	grande
广泛	guǎng fàn	amplamente
归纳	guī nà	indução
规矩	guī ju	regra
规律	guī lv4	lei
规模	guī mó	escala
规则	guī zé	regra
柜台	guì tái	contador
滚	gǔn	lista
锅	guō	panela
国庆节	guó qìng jié	dia nacional
国王	guó wáng	rei
果然	guǒ rán	realmente
果实	guǒ shí	fruta
过分	guò fèn	excessivo
过敏	guò mǐn	alergia
过期	guò qī	expirado
哈	hā	o que
海关	hǎi guān	costumes
海鲜	hǎi xiān	frutos do mar
喊	hǎn	ligar
行业	háng yè	indústria
豪华	háo huá	luxo
好客	hào kè	hospitaleiro
好奇	hào qí	curioso
何必	hé bì	porque se importar
何况	hé kuàng	para não mencionar
合法	hé fǎ	legítimo
合理	hé lǐ	razoável
合同	hé tong	contrato
合影	hé yǐng	foto de grupo
合作	hé zuò	cooperação
和平	hé píng	paz
核心	hé xīn	testemunho
恨	hèn	ódio
猴子	hóu zi	macaco
后背	hòu bèi	costas
后果	hòu guǒ	como resultado de
呼吸	hū xī	respirar
忽然	hū rán	de repente
忽视	hū shì	ignorar
壶	hú	panela
糊涂	hú tu	confuso
胡说	hú shuō	absurdo
胡同	hú tòng	beco
蝴蝶	hú dié	borboleta
花生	huā shēng	amendoim
华裔	huá yì	chinês
滑	huá	escorregar
划	huà	desenhar
化学	huà xué	química
话题	huà tí	tema
怀念	huái niàn	senhorita
怀孕	huái yùn	gravidez
缓解	huǎn jiě	facilidade
幻想	huàn xiǎng	fantasia
慌张	huāng zhāng	pânico
黄金	huáng jīn	ouro
恢复	huī fù	restaurar
挥	huī	onda
灰	huī	cinzento
灰尘	huī chén	poeira
灰心	huī xīn	desanimado
汇率	huì lv4	taxa de câmbio
婚礼	hūn lǐ	casamento
婚姻	hūn yīn	casamento
活跃	huó yuè	ativo
伙伴	huǒ bàn	parceiro
火柴	huǒ chái	fósforos
或许	huò xǔ	possivelmente
基本	jī běn	básico
机器	jī qì	máquina
激烈	jī liè	feroz
肌肉	jī ròu	músculo
及格	jí gé	passar
急忙	jí máng	precipitadamente
急诊	jí zhěn	emergência
极其	jí qí	extremamente
集合	jí hé	conjunto
集体	jí tǐ	coletivo
集中	jí zhōng	concentrado
寂寞	jì mò	solitário
系领带	jì lǐng dài	use uma gravata
纪录	jì lù	registro
纪律	jì lv4	disciplina
纪念	jì niàn	comemorar
计算	jì suàn	cálculo
记录	jì lù	gravação
记忆	jì yì	memória
嘉宾	jiā bīn	hóspede
夹子	jiā zi	grampo
家庭	jiā tíng	família
家务	jiā wù	tarefas domésticas
家乡	jiā xiāng	cidade natal
假如	jiǎ rú	e se
假设	jiǎ shè	hipótese
假装	jiǎ zhuāng	fingir
甲	jiǎ	uma
价值	jià zhí	valor
嫁	jià	casar
驾驶	jià shǐ	dirigir
兼职	jiān zhí	meio período
坚决	jiān jué	decididamente
坚强	jiān qiáng	forte
肩膀	jiān bǎng	ombro
艰巨	jiān jù	difícil
艰苦	jiān kǔ	difícil
剪刀	jiǎn dāo	tesouras
捡	jiǎn	pegar
简历	jiǎn lì	currículo
简直	jiǎn zhí	simplesmente
健身	jiàn shēn	ginástica
建立	jiàn lì	configuração
建设	jiàn shè	construção
建筑	jiàn zhù	construção
键盘	jiàn pán	teclado
讲究	jiǎng jiu	prestar atenção em
讲座	jiǎng zuò	palestra
酱油	jiàng yóu	molho de soja
交换	jiāo huàn	troca
交际	jiāo jì	comunicação
交往	jiāo wǎng	contato
浇	jiāo	derramar
胶水	jiāo shuǐ	cola
狡猾	jiǎo huá	destreza
角度	jiǎo dù	ângulo
教材	jiào cái	livro didático
教练	jiào liàn	treinador
教训	jiào xun	lição
接触	jiē chù	contato
接待	jiē dài	recepção
接近	jiē jìn	perto de
结实	jiē shi	sólido
阶段	jiē duàn	etapa
结构	jié gòu	estrutura
结合	jié hé	combinar
结论	jié lùn	em conclusão
结账	jié zhàng	a conta, por favor
节省	jié shěng	salve 
借口	jiè kǒu	com licença
届	jiè	sessão
戒	jiè	sair
戒指	jiè zhi	anel
金属	jīn shǔ	metal
尽快	jǐn kuài	assim que possível
紧急	jǐn jí	urgente
谨慎	jǐn shèn	cauteloso
尽力	jìn lì	faça o seu melhor
尽量	jìn liàng	tente
近代	jìn dài	tempos modernos
进步	jìn bù	progresso
进口	jìn kǒu	importar
精力	jīng lì	energia
精神	jīng shén	espírito
经典	jīng diǎn	clássico
经商	jīng shāng	fazendo negócios
经营	jīng yíng	operativo
酒吧	jiǔ bā	barra
救	jiù	salve 
救护车	jiù hù chē	ambulância
舅舅	jiù jiu	tio
居然	jū rán	inesperadamente
桔子	jú zi	laranja
俱乐部	jù lè bù	clube
具备	jù bèi	ter
具体	jù tǐ	específico
巨大	jù dà	enorme
据说	jù shuō	é dito que
捐	juān	doar
决赛	jué sài	finais
决心	jué xīn	determinação
绝对	jué duì	absoluto
角色	jué sè	funções
军事	jūn shì	militares
均匀	jūn yún	uniformemente
卡车	kǎ chē	caminhão
开发	kāi fā	desenvolvimento
开放	kāi fàng	abrir
开幕式	kāi mù shì	cerimônia de abertura
开水	kāi shuǐ	água fervente
砍	kǎn	cortar
看不起	kàn bu qǐ	desprezar
看望	kàn wàng	visita
靠	kào	por
颗	kē	peças
可见	kě jiàn	visível
可靠	kě kào	confiável
可怕	kě pà	terrível
克	kè	grama
克服	kè fú	superar
刻苦	kè kǔ	trabalho duro
客观	kè guān	objetivo
课程	kè chéng	curso
空间	kōng jiān	espaço
控制	kòng zhì	ao controle
空闲	kòng xián	ocioso
口味	kǒu wèi	gosto
夸	kuā	gabar-se
夸张	kuā zhāng	exagero
会计	kuài jì	contabilidade
宽	kuān	largura
昆虫	kūn chóng	inseto
扩大	kuò dà	expandir
辣椒	là jiāo	pimenta
拦	lán	barra
烂	làn	podre
朗读	lǎng dú	leia em voz alta
劳动	láo dòng	trabalho
劳驾	láo jià	desculpe
姥姥	lǎo lao	avó
老百姓	lǎo bǎi xìng	pessoas comuns
老板	lǎo bǎn	patrão
老婆	lǎo pó	esposa
老实	lǎo shi	honesto
老鼠	lǎo shǔ	rato
乐观	lè guān	otimismo
雷	léi	meu
类型	lèi xíng	tipos de
冷淡	lěng dàn	frio
厘米	lí mǐ	cm
梨	lí	pera
离婚	lí hūn	divórcio
理论	lǐ lùn	teoria
理由	lǐ yóu	razão
利润	lì rùn	lucro
利息	lì xī	interesse
利益	lì yì	interesse
利用	lì yòng	usar
力量	lì liang	poder
立即	lì jí	imediatamente
立刻	lì kè	imediatamente
联合	lián hé	junta
连忙	lián máng	rapidamente
连续	lián xù	contínuo
恋爱	liàn ài	apaixonado
粮食	liáng shi	comida
良好	liáng hǎo	boa
亮	liàng	brilhante
了不起	liǎo bu qǐ	surpreendente
列车	liè chē	trem
临时	lín shí	temporário
灵活	líng huó	flexível
铃	líng	sino
零件	líng jiàn	componentes
零食	líng shí	lanches
领导	lǐng dǎo	liderança
领域	lǐng yù	campo
流传	liú chuán	propagação
流泪	liú lèi	lágrimas
浏览	liú lǎn	squeaky toy
龙	lóng	dragão
漏	lòu	vazamento
录取	lù qǔ	admissão
录音	lù yīn	gravação
陆地	lù dì	terra
陆续	lù xù	um após o outro
轮流	lún liú	virar
论文	lùn wén	papel
逻辑	luó ji	lógica
落后	luò hòu	atrás
骂	mà	maldição
麦克风	mài kè fēng	microfone
馒头	mán tou	pão cozido no vapor
满足	mǎn zú	satisfazer
毛病	máo bìng	culpa
矛盾	máo dùn	contradição
冒险	mào xiǎn	aventura
贸易	mào yì	negociação
媒体	méi tǐ	meios de comunicação
煤炭	méi tàn	carvão
眉毛	méi mao	sobrancelha
美术	měi shù	arte
魅力	mèi lì	charme
梦想	mèng xiǎng	sonhe
密切	mì qiè	fechar
秘密	mì mì	segredo
秘书	mì shū	secretário
蜜蜂	mì fēng	abelha
面对	miàn duì	cara
面积	miàn jī	área
面临	miàn lín	voltado para
描写	miáo xiě	descrição
苗条	miáo tiáo	magro
敏感	mǐn gǎn	sensível
名牌	míng pái	marca famosa
名片	míng piàn	cartão de visitas
名胜古迹	míng shèng gǔ jì	locais de interesse
明确	míng què	claro
明显	míng xiǎn	óbvio
明星	míng xīng	celebridade
命令	mìng lìng	comando
命运	mìng yùn	destino
摸	mō	toque
摩托车	mó tuō chē	motocicleta
模仿	mó fǎng	imitar
模糊	mó hu	embaçado
模特	mó tè	modelo
陌生	mò shēng	estranho
某	mǒu	certo
木头	mù tou	madeira
目标	mù biāo	objetivos
目录	mù lù	índice
目前	mù qián	atualmente
哪怕	nǎ pà	mesmo se
难怪	nán guài	não admira
难免	nán miǎn	inevitável
脑袋	nǎo dài	cabeça
内部	nèi bù	interno
内科	nèi kē	medicina interna
嫩	nèn	concurso
能干	néng gàn	capaz
能源	néng yuán	energia
嗯	ńg	está bem
年代	nián dài	anos
年纪	nián jì	era
念	niàn	ler
宁可	nìng kě	em vez
牛仔裤	niú zǎi kù	jeans
农村	nóng cūn	área rural
农民	nóng mín	agricultor
农业	nóng yè	agricultura
浓	nóng	concentrado
女士	nv3 shì	em
欧洲	ōu zhōu	europa
偶然	ǒu rán	acidental
拍	pāi	atirar
派	pài	enviar
盼望	pàn wàng	esperança
培训	péi xùn	treinamento
培养	péi yǎng	cultivar
赔偿	péi cháng	compensação
佩服	pèi fú	admirar
配合	pèi hé	colaborar
盆	pén	potes
碰	pèng	colisão
批	pī	lote
批准	pī zhǔn	aprovar
披	pī	phi
疲劳	pí láo	fadiga
匹	pǐ	combine
片	piàn	folha
片面	piàn miàn	unilateral
飘	piāo	com o vento
拼音	pīn yīn	pinyin
频道	pín dào	canal
凭	píng	dependem
平均	píng jūn	média
平	píng	nível
平安	píng 'ān	seguro
平常	píng cháng	geralmente
平等	píng děng	igualdade
平方	píng fāng	quadrado
平衡	píng héng	saldo
平静	píng jìng	calma
评价	píng jià	avaliação
破产	pò chǎn	falência
破坏	pò huài	danificar
迫切	pò qiè	urgente
期待	qī dài	eu espero que
期间	qī jiān	período
其余	qí yú	o restante
奇迹	qí jì	milagre
企业	qǐ yè	empreendimento
启发	qǐ fā	iluminar
气氛	qì fēn	atmosfera
汽油	qì yóu	gasolina
签	qiān	placa
谦虚	qiān xū	modesto
前途	qián tú	futuro
浅	qiǎn	raso
欠	qiàn	devo
枪	qiāng	arma de fogo
墙	qiáng	parede
强调	qiáng diào	enfatizar
强烈	qiáng liè	forte
抢	qiǎng	agarrar
悄悄	qiāo qiāo	silenciosamente
瞧	qiáo	veja
巧妙	qiǎo miào	inteligente
切	qiē	cortar
亲爱	qīn ài	querido
亲切	qīn qiè	tipo
亲自	qīn zì	pessoalmente
勤奋	qín fèn	diligente
清淡	qīng dàn	luz
轻视	qīng shì	desprezo
轻易	qīng yì	facilmente
青	qīng	verde
青春	qīng chūn	juventude
青少年	qīng shào nián	adolescentes
情景	qíng jǐng	cena
情绪	qíng xù	humor
请求	qǐng qiú	solicitação
庆祝	qìng zhù	comemoro
球迷	qiú mí	ventilador
趋势	qū shì	tendência
取消	qǔ xiāo	cancelar
娶	qǔ	casar
去世	qù shì	faleceu
圈	quān	anel
全面	quán miàn	compreensivo
权利	quán lì	direito
权力	quán lì	esse poder
劝	quàn	aconselhar
缺乏	quē fá	falta de
确定	què dìng	determinar
确认	què rèn	confirme
群	qún	grupo
燃烧	rán shāo	combustão
绕	rào	por aí
热爱	rè ài	ame
热烈	rè liè	caloroso
热心	rè xīn	entusiasmado
人才	rén cái	talento
人口	rén kǒu	população
人类	rén lèi	humanidade
人民币	rén mín bì	rmb
人生	rén shēng	vida
人事	rén shì	pessoal
人物	rén wù	personagem
人员	rén yuán	pessoal
忍不住	rěn bu zhù	não posso ajudar
日常	rì cháng	diariamente
日程	rì chéng	cronograma
日历	rì lì	calendário
日期	rì qī	encontro
日用品	rì yòng pǐn	necessidades diárias
日子	rì zi	dia
如何	rú hé	como é
如今	rú jīn	agora
软	ruǎn	suave
软件	ruǎn jiàn	programas
弱	ruò	fraco
洒	sǎ	borrifar
嗓子	sǎng zi	voz
色彩	sè cǎi	cor
杀	shā	matar
沙漠	shā mò	deserto
沙滩	shā tān	de praia
傻	shǎ	estúpido
晒	shài	mostrar
删除	shān chú	excluir
闪电	shǎn diàn	relâmpago
善良	shàn liáng	bondade
善于	shàn yú	bom em
扇子	shàn zi	ventilador
伤害	shāng hài	doeu
商品	shāng pǐn	mercadoria
商务	shāng wù	o negócio
商业	shāng yè	o negócio
上当	shàng dàng	enganado
蛇	shé	serpente
舍不得	shě bu de	relutante
射击	shè jī	tiroteio
摄影	shè yǐng	fotografia
设备	shè bèi	equipamento
设计	shè jì	projeto
设施	shè shī	instalação
伸	shēn	esticam
深刻	shēn kè	profundo
身材	shēn cái	figura
身份	shēn fèn	identidade
神话	shén huà	mito
神秘	shén mì	misterioso
升	shēng	subir
声调	shēng diào	tom
生产	shēng chǎn	produzir
生动	shēng dòng	vívido
生长	shēng zhǎng	crescer
绳子	shéng zi	corda
省略	shěng lüè	omitir
胜利	shèng lì	vitória
失眠	shī mián	insônia
失去	shī qù	perder
失业	shī yè	desemprego
湿润	shī rùn	úmido
狮子	shī zi	leão
诗	shī	poesia
实话	shí huà	verdade
实践	shí jiàn	prática
实习	shí xí	prática
实现	shí xiàn	alcançar
实验	shí yàn	experimentar
实用	shí yòng	prático
时差	shí chā	fuso horário
时代	shí dài	era
时刻	shí kè	tempo
时髦	shí máo	elegante
时期	shí qī	período
时尚	shí shàng	moda
石头	shí tou	pedra
食物	shí wù	comida
使劲儿	shǐ jìn r	difícil
始终	shǐ zhōng	sempre
事实	shì shí	facto
事物	shì wù	coisa
事先	shì xiān	antecipadamente
似的	shì de	gostar
士兵	shì bīng	soldado
市场	shì chǎng	mercado
试卷	shì juàn	papel de teste
收获	shōu huò	recompensa
收据	shōu jù	recibo
手工	shǒu gōng	manual
手术	shǒu shù	cirurgia
手套	shǒu tào	luvas
手续	shǒu xù	formalidades
手指	shǒu zhǐ	dedo
首	shǒu	primeiro
受伤	shòu shāng	ferido
寿命	shòu mìng	vida
书架	shū jià	estante
梳子	shū zi	pente
舒适	shū shì	confortável
蔬菜	shū cài	legumes
输入	shū rù	entrar
熟练	shú liàn	especializado
属于	shǔ yú	pertencer
数	shǔ	número
鼠标	shǔ biāo	rato
数据	shù jù	dados
数码	shù mǎ	digital
摔倒	shuāi dǎo	cair
甩	shuǎi	despejar
双方	shuāng fāng	ambos os lados
税	shuì	imposto
说不定	shuō bu dìng	talvez
说服	shuō fú	convencer
丝绸	sī chóu	seda
丝毫	sī háo	o mais leve
思考	sī kǎo	pensando
思想	sī xiǎng	pensamento
撕	sī	lágrima
私人	sī rén	privado
似乎	sì hū	parece
搜索	sōu suǒ	procurar por
宿舍	sù shè	dormitório
随身	suí shēn	carregar
随时	suí shí	a qualquer momento
随手	suí shǒu	casualmente
碎	suì	partido
损失	sǔn shī	perda
缩短	suō duǎn	encurtar
所	suǒ	então
锁	suǒ	fechadura
台阶	tái jiē	passos
太极拳	tài jí quán	tai chi
太太	tài tai	sra
谈判	tán pàn	negociação
坦率	tǎn shuài	franco
烫	tàng	quente
桃	táo	pêssego
淘气	táo qì	danadinho
逃	táo	escapar
逃避	táo bì	escapar
讨价还价	tǎo jià huán jià	pechincha
套	tào	conjunto
特色	tè sè	características
特殊	tè shū	especial
特征	tè zhēng	característica
疼爱	téng ài	ame
提倡	tí chàng	promover
提纲	tí gāng	esboço
提问	tí wèn	pergunte
题目	tí mù	tema
体会	tǐ huì	experiência
体贴	tǐ tiē	atencioso
体现	tǐ xiàn	refletir
体验	tǐ yàn	experiência
天空	tiān kōng	céu
天真	tiān zhēn	ingênuo
调皮	tiáo pí	danadinho
调整	tiáo zhěng	ajustamento
挑战	tiǎo zhàn	desafio
通常	tōng cháng	geralmente
统一	tǒng yī	unir
痛苦	tòng kǔ	dor
痛快	tòng kuài	feliz
偷	tōu	roubar
投入	tóu rù	investem no
投资	tóu zī	investimento
透明	tòu míng	transparente
突出	tū chū	proeminente
土地	tǔ dì	terra
土豆	tǔ dòu	batata
兔子	tù zi	coelho
吐	tù	vomitou
团	tuán	grupo
推辞	tuī cí	declínio
推广	tuī guǎng	promover
推荐	tuī jiàn	recomendar
退	tuì	retiro
退步	tuì bù	regressar
退休	tuì xiū	aposentadoria
歪	wāi	torto
外公	wài gōng	vovô
外交	wài jiāo	diplomático
完美	wán měi	perfeito
完善	wán shàn	perfeito
完整	wán zhěng	completo
玩具	wán jù	brinquedo
万一	wàn yī	apenas no caso de
王子	wáng zǐ	principe
往返	wǎng fǎn	ida e volta
网络	wǎng luò	a internet
危害	wēi hài	prejuízo
威胁	wēi xié	ameaça
微笑	wēi xiào	sorrir
唯一	wéi yī	só
围巾	wéi jīn	cachecol
围绕	wéi rào	por aí
维修	wéi xiū	serviço
违反	wéi fǎn	violação
伟大	wěi dà	ótimo
委屈	wěi qū	errado
尾巴	wěi ba	rabo
位于	wèi yú	deitar em
位置	wèi zhi	posição
未必	wèi bì	não necessariamente
未来	wèi lái	futuro
胃	wèi	estômago
胃口	wèi kǒu	apetite
温暖	wēn nuǎn	caloroso
温柔	wēn róu	concurso
文件	wén jiàn	arquivo
文具	wén jù	papelaria
文明	wén míng	civilização
文学	wén xué	literatura
文字	wén zì	texto
闻	wén	cheiro
吻	wěn	beijo
稳定	wěn dìng	estábulo
问候	wèn hòu	saudações
卧室	wò shì	quarto
握手	wò shǒu	apertar as mãos
屋子	wū zi	quarto
无奈	wú nài	desamparado
无数	wú shù	incontáveis
无所谓	wú suǒ wèi	não importa
武术	wǔ shù	artes marciais
勿	wù	não
物理	wù lǐ	fisica
物质	wù zhì	substância
雾	wù	névoa
吸取	xī qǔ	desenhar
吸收	xī shōu	absorver
戏剧	xì jù	drama
系	xì	sistema
系统	xì tǒng	sistema
细节	xì jié	detalhe
瞎	xiā	cego
下载	xià zǎi	baixar
吓	xià	susto
夏令营	xià lìng yíng	campo de verão
鲜艳	xiān yàn	brilhante
显得	xiǎn de	aparecer
显然	xiǎn rán	obviamente
显示	xiǎn shì	exibição
县	xiàn	município
现代	xiàn dài	moderno
现实	xiàn shí	realidade
现象	xiàn xiàng	fenômeno
限制	xiàn zhì	limite
相处	xiāng chǔ	lidar, se dar bem, conviver
相当	xiāng dāng	bastante
相对	xiāng duì	relativamente
相关	xiāng guān	relacionados
相似	xiāng sì	semelhante
香肠	xiāng cháng	linguiça
享受	xiǎng shòu	apreciar
想念	xiǎng niàn	senhorita
想象	xiǎng xiàng	imagine
象棋	xiàng qí	xadrez
象征	xiàng zhēng	símbolo
项	xiàng	item
项链	xiàng liàn	colar
项目	xiàng mù	projeto
消费	xiāo fèi	consumo
消化	xiāo huà	digestão
消极	xiāo jí	negativo
消失	xiāo shī	desaparecer
销售	xiāo shòu	vendas
小麦	xiǎo mài	trigo
小气	xiǎo qi	mesquinho
孝顺	xiào shun	piedade filial
效率	xiào lv4	eficácia
歇	xiē	descansar
斜	xié	oblíquo
写作	xiě zuò	escrita
心理	xīn lǐ	psicológico
心脏	xīn zàng	coração
欣赏	xīn shǎng	apreciar
信号	xìn hào	sinal
信任	xìn rèn	confiar em
形成	xíng chéng	formato
形容	xíng róng	descrever
形势	xíng shì	situação
形式	xíng shì	formato
形象	xíng xiàng	imagem
形状	xíng zhuàng	forma
行动	xíng dòng	açao
行人	xíng rén	pedestre
行为	xíng wéi	comportamento
幸亏	xìng kuī	felizmente
幸运	xìng yùn	por sorte
性质	xìng zhì	natureza
兄弟	xiōng dì	irmãos
胸	xiōng	peito
休闲	xiū xián	casual
修改	xiū gǎi	modificar
虚心	xū xīn	modesto
叙述	xù shù	narrar
宣布	xuān bù	anunciar
宣传	xuān chuán	publicidade
学历	xué lì	educação
学术	xué shù	acadêmico
学问	xué wèn	conhecimento
血	xuè	sangue
寻找	xún zhǎo	pesquisa
询问	xún wèn	perguntar
训练	xùn liàn	treinamento
迅速	xùn sù	rápido
押金	yā jīn	depósito
牙齿	yá chǐ	dente
严肃	yán sù	grave
延长	yán cháng	ampliar
演讲	yǎn jiǎng	discurso
宴会	yàn huì	banquete
阳台	yáng tái	sacada
痒	yǎng	coceira
样式	yàng shì	estilo
腰	yāo	cintura
摇	yáo	mexe
咬	yǎo	mordida
要不	yào bù	ou
业务	yè wù	o negócio
业余	yè yú	amador
夜	yè	noite
依然	yī rán	ainda
一辈子	yí bèi zi	tempo de vida
一旦	yí dàn	uma vez
一律	yí lv4	sempre
一再	yí zài	repetidamente
一致	yí zhì	consistente
疑问	yí wèn	dúvida
移动	yí dòng	móvel
移民	yí mín	imigração
遗憾	yí hàn	arrepender
乙	yǐ	b
以及	yǐ jí	assim como
以来	yǐ lái	desde a
义务	yì wù	obrigação
亿	yì	bilhão
意外	yì wài	acidente
意义	yì yì	significado
议论	yì lùn	falar
因而	yīn ér	portanto
因素	yīn sù	fator
银	yín	prata
印刷	yìn shuā	impressão
英俊	yīng jùn	bonito
英雄	yīng xióng	herói
营养	yíng yǎng	nutrição
营业	yíng yè	o negócio
迎接	yíng jiē	conheçer
影子	yǐng zi	sombra
应付	yìng fu	lidar com
应用	yìng yòng	inscrição
硬	yìng	difícil
硬件	yìng jiàn	hardware
拥抱	yōng bào	abraço
拥挤	yōng jǐ	lotado
勇气	yǒng qì	coragem
用功	yòng gōng	trabalhar duro
用途	yòng tú	usar
优惠	yōu huì	desconto
优美	yōu měi	lindo
优势	yōu shì	vantagem
悠久	yōu jiǔ	longo
油炸	yóu zhá	frito
游览	yóu lǎn	tour
犹豫	yóu yù	hesite
有利	yǒu lì	favorável
幼儿园	yòu ér yuán	jardim da infância
娱乐	yú lè	entretenimento
与其	yǔ qí	ao invés de
语气	yǔ qì	tom
玉米	yù mǐ	milho
预报	yù bào	previsão
预订	yù dìng	reserva
预防	yù fáng	prevenção
元旦	yuán dàn	dia de ano novo
原料	yuán liào	matéria-prima
原则	yuán zé	em princípio
员工	yuán gōng	empregado
圆	yuán	volta
愿望	yuàn wàng	desejo
乐器	yuè qì	instrumento musical
晕	yūn	poxa
运气	yùn qi	sorte
运输	yùn shū	transporte
运用	yùn yòng	usar
灾害	zāi hài	desastre
再三	zài sān	repetidamente
在乎	zài hu	cuidado
在于	zài yú	mentiras em
赞成	zàn chéng	aceita
赞美	zàn měi	elogio
糟糕	zāo gāo	mau
造成	zào chéng	causa
则	zé	então
责备	zé bèi	culpa
摘	zhāi	escolher
窄	zhǎi	limitar
粘贴	zhān tiē	colar
展开	zhǎn kāi	desdobrar
展览	zhǎn lǎn	exibição
占	zhàn	assumir
战争	zhàn zhēng	guerra
掌握	zhǎng wò	aperto
涨	zhǎng	subir
长辈	zhǎng bèi	mais velho
账户	zhàng hù	conta
招待	zhāo dài	entreter
着火	zháo huǒ	em chamas
着凉	zháo liáng	pegar um resfriado
召开	zhào kāi	aguarde
照常	zhào cháng	como sempre
哲学	zhé xué	filosofia
珍惜	zhēn xī	prezar
真实	zhēn shí	real
针对	zhēn duì	contra
诊断	zhěn duàn	diagnóstico
振动	zhèn dòng	vibração
阵	zhèn	array
争论	zhēng lùn	debate
争取	zhēng qǔ	esforce-se para
征求	zhēng qiú	procurar
挣	zhēng	ganhar
睁	zhēng	olhos abertos
整个	zhěng gè	inteira
整齐	zhěng qí	arrumado
整体	zhěng tǐ	no geral
政府	zhèng fǔ	governo
政治	zhèng zhì	político
正	zhèng	positivo
证件	zhèng jiàn	certificado
证据	zhèng jù	provas
支	zhī	apoio, suporte
支票	zhī piào	verifica
执照	zhí zhào	licença
直	zhí	direto
指导	zhǐ dǎo	guia
指挥	zhǐ huī	comando
制定	zhì dìng	faço
制度	zhì dù	sistema
制造	zhì zào	fabricar
制作	zhì zuò	faço
志愿者	zhì yuàn zhě	voluntário
智慧	zhì huì	sabedoria
治疗	zhì liáo	tratamento
秩序	zhì xù	ordem
至今	zhì jīn	até a presente data
至于	zhì yú	quanto a
中介	zhōng jiè	intermediário
中心	zhōng xīn	centro
中旬	zhōng xún	médio prazo
种类	zhǒng lèi	espécies
重大	zhòng dà	principal
重量	zhòng liàng	peso
周到	zhōu dao	pensativo
猪	zhū	porco
竹子	zhú zi	bambu
逐步	zhú bù	passo a passo
逐渐	zhú jiàn	gradualmente
主持	zhǔ chí	hospedeiro
主动	zhǔ dòng	iniciativa
主观	zhǔ guān	subjetivo
主人	zhǔ rén	o hospedeiro
主任	zhǔ rèn	diretor
主题	zhǔ tí	tema
主席	zhǔ xí	presidente
主张	zhǔ zhāng	afirmação
煮	zhǔ	cozinhar
注册	zhù cè	registrado
祝福	zhù fú	bênção
抓	zhuā	agarrar
抓紧	zhuā jǐn	preste muita atenção
专家	zhuān jiā	especialista
专心	zhuān xīn	concentrado
转变	zhuǎn biàn	mudança
转告	zhuǎn gào	contar
装	zhuāng	instalar
装饰	zhuāng shì	decoração
装修	zhuāng xiū	decoração
撞	zhuàng	bater
状况	zhuàng kuàng	situação
状态	zhuàng tài	status
追	zhuī	correr atrás
追求	zhuī qiú	perseguir
咨询	zī xún	consultivo
姿势	zī shì	postura
资格	zī gé	qualificações
资金	zī jīn	fundos
资料	zī liào	dados
资源	zī yuán	recursos
紫	zǐ	roxa
字母	zì mǔ	carta
字幕	zì mù	subtítulo
自从	zì cóng	desde a
自动	zì dòng	automático
自豪	zì háo	orgulho
自觉	zì jué	consciente
自私	zì sī	egoísta
自由	zì yóu	livre
自愿	zì yuàn	voluntário
综合	zōng hé	compreensivo
总裁	zǒng cái	presidente
总共	zǒng gòng	no total
总理	zǒng lǐ	primeiro ministro
总算	zǒng suàn	finalmente
总统	zǒng tǒng	presidente
总之	zǒng zhī	em resumo
组	zǔ	grupo
组成	zǔ chéng	composição
组合	zǔ hé	combinação
组织	zǔ zhī	organização
阻止	zǔ zhǐ	evita
最初	zuì chū	inicial
醉	zuì	bêbado
尊敬	zūn jìng	respeito
遵守	zūn shǒu	cumprir com
作品	zuò pǐn	trabalho
作为	zuò wéi	como
作文	zuò wén	composição
