挨	ái	sofra
癌症	ái zhèng	câncer
暧昧	ài mèi	ambíguo
爱不释手	ài bù shì shǒu	abaixe
爱戴	ài dài	ame
安宁	ān níng	pacífico
安详	ān xiáng	sereno
安置	ān zhì	colocação
按摩	àn mó	massagem
暗示	àn shì	dica
案件	àn jiàn	caso
案例	àn lì	caso
昂贵	áng guì	caro
凹凸	āo tū	colisão
熬	áo	ferver
奥秘	ào mì	mistério
巴不得	bā bù dé	ansioso
巴结	bā jie	fawn
扒	bā	grade
疤	bā	cicatriz
拔苗助长	bá miáo zhù zhǎng	desenraizamento
把关	bǎ guān	verifica
把手	bǎ shǒu	lidar com
罢工	bà gōng	greve
霸道	bà dào	arrogante
掰	bāi	tchau
摆脱	bǎi tuō	livrar-se de
拜访	bài fǎng	visita
拜年	bài nián	feliz ano novo
拜托	bài tuō	por favor
败坏	bài huài	corrupto
斑	bān	local
颁布	bān bù	promulgar
颁发	bān fā	questão
版本	bǎn běn	versão
伴侣	bàn lv3	companheiro
伴随	bàn suí	acompanhando
半途而废	bàn tú ér fèi	desistir no meio do caminho
扮演	bàn yǎn	jogar
榜样	bǎng yàng	exemplo
绑架	bǎng jià	sequestro
磅	bàng	libra
包庇	bāo bì	abrigo
包袱	bāo fu	fardo
包围	bāo wéi	cercado
包装	bāo zhuāng	pacote
保管	bǎo guǎn	custódia
保密	bǎo mì	guarde segredo
保姆	bǎo mǔ	babá
保守	bǎo shǒu	conservador
保卫	bǎo wèi	defender
保养	bǎo yǎng	manutenção
保障	bǎo zhàng	garantia
保重	bǎo zhòng	cuidar
饱和	bǎo hé	saturação
饱经沧桑	bǎo jīng cāng sāng	vicissitudes
报酬	bào chou	remuneração
报仇	bào chóu	vingança
报答	bào dá	reembolsar
报复	bào fù	vingança
报警	bào jǐng	chame a polícia
报销	bào xiāo	reembolso
抱负	bào fù	ambição
暴力	bào lì	violência
暴露	bào lù	exposto
曝光	bào guāng	exposição
爆发	bào fā	saia
爆炸	bào zhà	explosão
卑鄙	bēi bǐ	significar
悲哀	bēi āi	tristeza
悲惨	bēi cǎn	trágico
北极	běi jí	ártico
备份	bèi fèn	cópia de segurança
备忘录	bèi wàng lù	memorando
背叛	bèi pàn	trair
背诵	bèi sòng	recitar
被动	bèi dòng	passiva
被告	bèi gào	réu
贝壳	bèi ké	concha
奔波	bēn bō	corra em volta
奔驰	bēn chí	benz
本能	běn néng	instinto
本钱	běn qián	capital
本人	běn rén	eu mesmo
本身	běn shēn	em si
本事	běn shi	habilidade
笨拙	bèn zhuō	desajeitado
崩溃	bēng kuì	colapso
甭	béng	não
蹦	bèng	saltar
迸发	bèng fā	estouro
逼迫	bī pò	força
鼻涕	bí tì	nariz
比方	bǐ fang	por exemplo
比喻	bǐ yù	metáfora
比重	bǐ zhòng	proporção
鄙视	bǐ shì	desprezar
弊病	bì bìng	mal-estar
弊端	bì duān	desvantagens
臂	bì	braço
闭塞	bì sè	ocluir
编织	biān zhī	tecer
边疆	biān jiāng	fronteira
边界	biān jiè	fronteira
边境	biān jìng	fronteira
边缘	biān yuán	beira
鞭策	biān cè	spur
扁	biǎn	plano
贬低	biǎn dī	menosprezar
贬义	biǎn yì	depreciativo
便利	biàn lì	conveniente
便条	biàn tiáo	nota
便于	biàn yú	fácil de
变故	biàn gù	infortúnio
变迁	biàn qiān	mudança
变质	biàn zhì	deterioração
辨认	biàn rèn	identificar
辩护	biàn hù	defender
辩解	biàn jiě	com licença
辩证	biàn zhèng	dialético
辫子	biàn zi	trança
遍布	biàn bù	por toda parte
标本	biāo běn	espécime
标记	biāo jì	marca
标题	biāo tí	título
表决	biǎo jué	voto
表态	biǎo tài	posição
表彰	biǎo zhāng	reconhecimento
憋	biē	espera um pouco
别墅	bié shù	villa
别致	bié zhì	chique
别扭	biè niu	desajeitado
濒临	bīn lín	à beira de
冰雹	bīng báo	saudar
丙	bǐng	c
并非	bìng fēi	não
并列	bìng liè	lado a lado
剥削	bō xuē	explorar
拨	bō	discar
播种	bō zhòng	semeadura
波浪	bō làng	onda
波涛	bō tāo	ondas
伯母	bó mǔ	tia
博大精深	bó dà jīng shēn	amplo e profundo
博览会	bó lǎn huì	justo
搏斗	bó dòu	luta
薄弱	bó ruò	fraco
不顾	bú gù	independentemente de
不愧	bú kuì	digno de
不料	bú liào	inesperadamente
不像话	bú xiàng huà	ultrajante, ultrajoso
不屑一顾	bú xiè yī gù	dismissivo
哺乳	bǔ rǔ	amamentação
捕捉	bǔ zhuō	capturar
补偿	bǔ cháng	maquiagem
补救	bǔ jiù	remédio
补贴	bǔ tiē	subvenção
不得已	bù dé yǐ	último recurso
不妨	bù fáng	poderia muito bem
不敢当	bù gǎn dāng	não ouse ser
不禁	bù jīn	não posso ajudar
不堪	bù kān	insuportável
不可思议	bù kě sī yì	incrível
不免	bù miǎn	inevitavelmente
不时	bù shí	de tempos em tempos
不惜	bù xī	não hesite
不相上下	bù xiāng shàng xià	comparável
不言而喻	bù yán ér yù	é evidente
不由得	bù yóu de	não posso ajudar, mas
不择手段	bù zé shǒu duàn	jogar difícil
不止	bù zhǐ	mais que
布告	bù gào	aviso prévio
布局	bù jú	layout
布置	bù zhì	layout
步伐	bù fá	ritmo
部署	bù shǔ	implantar
部位	bù wèi	localização
才干	cái gàn	competência
裁缝	cái feng	alfaiate
裁判	cái pàn	juiz
裁员	cái yuán	demissões
财富	cái fù	riqueza
财务	cái wù	finança
财政	cái zhèng	financeiro
彩票	cǎi piào	loteria
采购	cǎi gòu	compra
采集	cǎi jí	coleção
采纳	cǎi nà	adoção
参谋	cān móu	funcionários
参照	cān zhào	referência
残疾	cán jí	incapacidade
残酷	cán kù	cruel
残留	cán liú	resíduo
残忍	cán rěn	cruel
灿烂	càn làn	brilhante
仓促	cāng cù	apressado
仓库	cāng kù	armazém
舱	cāng	cabine
苍白	cāng bái	pálido
操劳	cāo láo	trabalhar duro
操练	cāo liàn	prática
操纵	cāo zòng	manipular
操作	cāo zuò	operativo
嘈杂	cáo zá	barulhento
草案	cǎo àn	esboço, projeto
草率	cǎo shuài	apressado
侧面	cè miàn	lado
测量	cè liáng	medindo
策划	cè huà	plano
策略	cè lvè	estratégia
层出不穷	céng chū bù qióng	sem fim
层次	céng cì	nível
差别	chā bié	diferença
插座	chā zuò	tomada
查获	chá huò	apreendido
刹那	chà nà	momento
岔	chà	garfo
诧异	chà yì	surpreso
柴油	chái yóu	óleo diesel
搀	chān	misturar
缠绕	chán rào	enrolamento
馋	chán	ávido
产业	chǎn yè	indústria
阐述	chǎn shù	elaborar
颤抖	chàn dǒu	tremendo
昌盛	chāng shèng	prosperidade
偿还	cháng huán	reembolsar
尝试	cháng shì	tentar
场合	chǎng hé	ocasião
场面	chǎng miàn	cena
场所	chǎng suǒ	lugar, colocar
敞开	chǎng kāi	totalmente aberto
倡导	chàng dǎo	advogado
倡议	chàng yì	iniciativa
畅通	chàng tōng	desbloqueado
畅销	chàng xiāo	mais vendidos
超越	chāo yuè	além
钞票	chāo piào	nota de banco
嘲笑	cháo xiào	arremesar em dentes
巢穴	cháo xué	ninho
朝代	cháo dài	dinastia
潮流	cháo liú	tendência
撤退	chè tuì	retiro
撤销	chè xiāo	revogar
沉淀	chén diàn	precipitação
沉闷	chén mèn	maçante
沉思	chén sī	meditação
沉重	chén zhòng	pesado
沉着	chén zhuó	calma
陈旧	chén jiù	obsoleto
陈列	chén liè	exibição
陈述	chén shù	declaração
称心如意	chèn xīn rú yì	satisfatório
衬托	chèn tuō	zarpar, fugir
称号	chēng hào	título
乘	chéng	multiplicar
呈现	chéng xiàn	presente
城堡	chéng bǎo	castelo
惩罚	chéng fá	punição
成本	chéng běn	custo
成交	chéng jiāo	combinado
成天	chéng tiān	o dia inteiro
成效	chéng xiào	eficácia
成心	chéng xīn	deliberadamente
成员	chéng yuán	membro
承办	chéng bàn	empreender
承包	chéng bāo	contrato
承诺	chéng nuò	compromissado com
橙	chéng	laranja
澄清	chéng qīng	esclarecer
盛	chéng	sheng
诚挚	chéng zhì	sincero
秤	chèng	escalas
吃苦	chī kǔ	sofra
吃力	chī lì	extenuante
持久	chí jiǔ	duradouro
迟钝	chí dùn	lento
迟缓	chí huǎn	lento
迟疑	chí yí	hesita
赤道	chì dào	equatorial
赤字	chì zì	déficit
充当	chōng dāng	agir como
充沛	chōng pèi	abundante
充实	chōng shí	enriquecer
充足	chōng zú	adequado
冲动	chōng dòng	impulso
冲击	chōng jī	choque
冲突	chōng tū	conflito
崇拜	chóng bài	adoração
崇高	chóng gāo	sublime
崇敬	chóng jìng	respeito
重叠	chóng dié	sobreposto
稠密	chóu mì	denso
筹备	chóu bèi	preparação
丑恶	chǒu è	feio
出路	chū lù	saída
出卖	chū mài	vender
出身	chū shēn	origem
出神	chū shén	transe
出息	chū xi	excepcional
初步	chū bù	preliminares
除	chú	exceto
储备	chǔ bèi	reserva
储存	chǔ cún	loja
储蓄	chǔ xù	poupança
处分	chǔ fèn	sanção
处境	chǔ jìng	situação
处置	chǔ zhì	descarte de
触犯	chù fàn	ofender
川流不息	chuān liú bù xī	fluxo constante
穿越	chuān yuè	atravessar
传达	chuán dá	transmitir
传单	chuán dān	folheto
传授	chuán shòu	ensinar
船舶	chuán bó	navio
喘气	chuǎn qì	calça
串	chuàn	corda
床单	chuáng dān	lençol
创立	chuàng lì	fundado
创新	chuàng xīn	inovação
创业	chuàng yè	começar um negócio
创作	chuàng zuò	criação
吹牛	chuī niú	gabar-se
吹捧	chuī pěng	bajular
炊烟	chuī yān	fumaça de cozinha
垂直	chuí zhí	vertical
锤	chuí	martelo
纯粹	chún cuì	puramente
纯洁	chún jié	puro
慈善	cí shàn	caridoso
慈祥	cí xiáng	gentilmente
磁带	cí dài	fita
雌雄	cí xióng	masculino e feminino
伺候	cì hòu	servir
刺	cì	espinho
次品	cì pǐn	defeituoso
次序	cì xù	ordem
丛	cóng	clump
从容	cóng róng	calmamente
凑合	còu he	improvisar
粗鲁	cū lǔ	grosseiro
窜	cuàn	canal
摧残	cuī cán	devastação
脆弱	cuì ruò	frágil
搓	cuō	torção
磋商	cuō shāng	consulta
挫折	cuò zhé	frustração
搭	dā	toma
搭档	dā dàng	parceiro
搭配	dā pèi	combine
答辩	dá biàn	resposta
答复	dá fù	resposta
达成	dá chéng	alcance
打包	dǎ bāo	fardo
打官司	dǎ guān si	litígio
打击	dǎ jī	golpe
打架	dǎ jià	luta
打量	dǎ liang	olhe para
打猎	dǎ liè	caçar
打仗	dǎ zhàng	luta
大不了	dà bù liǎo	grande negócio
大臣	dà chén	ministro
大伙儿	dà huǒ r	todos
大肆	dà sì	arbitrariamente
大体	dà tǐ	em geral
大意	dà yì	ideia principal
大致	dà zhì	aproximadamente
歹徒	dǎi tú	gangster
代价	dài jià	custo
代理	dài lǐ	procuração
带领	dài lǐng	conduzir
怠慢	dài màn	negligência
逮捕	dài bǔ	prender
担保	dān bǎo	garantia
胆怯	dǎn qiè	tímido
淡季	dàn jì	entressafra
淡水	dàn shuǐ	água fresca
蛋白质	dàn bái zhì	proteína
诞辰	dàn chén	aniversário
诞生	dàn shēng	nascermos
当场	dāng chǎng	no local
当初	dāng chū	no inicio
当代	dāng dài	contemporâneo
当面	dāng miàn	cara a cara
当前	dāng qián	atual
当事人	dāng shì rén	festa
当务之急	dāng wù zhī jí	imperativo
当选	dāng xuǎn	eleito
党	dǎng	festa
档案	dàng àn	arquivo
档次	dàng cì	grau
倒闭	dǎo bì	colapso
导弹	dǎo dàn	míssil
导航	dǎo háng	navegação
导向	dǎo xiàng	guia
捣乱	dǎo luàn	arranjar problemas
盗窃	dào qiè	roubo
稻谷	dào gǔ	arroz
得不偿失	dé bù cháng shī	não vale a pena perder
得力	dé lì	eficaz
得天独厚	dé tiān dú hòu	abençoado
得罪	dé zuì	ofender
灯笼	dēng lóng	lanterna
登录	dēng lù	conecte-se
登陆	dēng lù	assinar em
蹬	dēng	pontapé
等候	děng hòu	esperando
等级	děng jí	grau
瞪	dèng	olhar fixamente
堤坝	dī bà	barragem
敌视	dí shì	hostil
抵达	dǐ dá	chegada
抵抗	dǐ kàng	resistência
抵制	dǐ zhì	resistir
地步	dì bù	ponto
地势	dì shì	terreno
地质	dì zhì	geologia
递增	dì zēng	aumentar
颠簸	diān bǒ	solavancos
颠倒	diān dǎo	reverter
典礼	diǎn lǐ	cerimônia
典型	diǎn xíng	típica
点缀	diǎn zhuì	embelezamento
垫	diàn	almofada
奠定	diàn dìng	deitar
惦记	diàn jì	preocupado sobre
电源	diàn yuán	fonte de energia
叼	diāo	dangle
雕刻	diāo kè	escultura
雕塑	diāo sù	escultura
吊	diào	aguentar
调动	diào dòng	mobilizar
跌	diē	cair
丁	dīng	ding
叮嘱	dīng zhǔ	exortar
盯	dīng	olhar fixamente
定期	dìng qī	regular
定义	dìng yì	definição
丢人	diū rén	vergonha
丢三落四	diū sān là sì	perder tudo
东道主	dōng dào zhǔ	hospedeiro
东张西望	dōng zhāng xī wàng	olhando em volta
董事长	dǒng shì zhǎng	presidente
冻结	dòng jié	congelar
动荡	dòng dàng	turbulência
动机	dòng jī	motivação
动静	dòng jìng	movimento
动力	dòng lì	poder
动脉	dòng mài	artéria
动身	dòng shēn	sair
动手	dòng shǒu	mãos em
动态	dòng tài	dinâmico
动员	dòng yuán	mobilização
栋	dòng	dong
兜	dōu	bolso
陡峭	dǒu qiào	íngreme
斗争	dòu zhēng	luta
督促	dū cù	impulso
毒品	dú pǐn	medicamento
独裁	dú cái	ditadura
堵塞	dǔ sè	bloqueio
赌博	dǔ bó	jogos de azar
杜绝	dù jué	por um fim a
端	duān	fim
端午节	duān wǔ jié	festival do barco-dragão
端正	duān zhèng	corrigir
短促	duǎn cù	curto
断定	duàn dìng	determinar
断绝	duàn jué	corte fora
堆积	duī jī	acumulação
兑现	duì xiàn	dinheiro
对策	duì cè	contramedida
对称	duì chèn	simetria
对付	duì fu	lide com
对抗	duì kàng	confronto
对立	duì lì	oposição
对联	duì lián	par de versos
对应	duì yìng	corresponder
对照	duì zhào	ao controle
队伍	duì wu	equipe
顿时	dùn shí	de repente
哆嗦	duō suo	tremendo
多元化	duō yuán huà	diversificação
堕落	duò luò	depravado
额外	é wài	adicional
恶心	ě xin	náusea
恶化	è huà	deterioração
遏制	è zhì	conter
恩怨	ēn yuàn	ressentimento
而已	ér yǐ	é isso aí
二氧化碳	èr yǎng huà tàn	dióxido de carbono
发布	fā bù	liberação
发财	fā cái	ficar rico
发呆	fā dāi	deslumbramento
发动	fā dòng	lançamento
发觉	fā jué	encontrar
发射	fā shè	emissão
发誓	fā shì	xingar
发行	fā xíng	emitido
发炎	fā yán	febre
发扬	fā yáng	levar adiante
发育	fā yù	desenvolvimento
法人	fǎ rén	pessoa jurídica
番	fān	ventilador
凡是	fán shì	todos
繁华	fán huá	movimentado
繁忙	fán máng	ocupado
繁体字	fán tǐ zì	chinês tradicional
繁殖	fán zhí	procriar
反驳	fǎn bó	refutar
反常	fǎn cháng	anormal
反感	fǎn gǎn	não gosto
反抗	fǎn kàng	revolta
反馈	fǎn kuì	comentários
反面	fǎn miàn	negativo
反射	fǎn shè	reflexão
反思	fǎn sī	reflexão
反问	fǎn wèn	questão retórica
反之	fǎn zhī	pelo contrário
泛滥	fàn làn	inundar
范畴	fàn chóu	categoria
贩卖	fàn mài	vender
方位	fāng wèi	posição
方言	fāng yán	dialeto
方圆	fāng yuán	fangyuan
方针	fāng zhēn	política
防守	fáng shǒu	defensiva
防御	fáng yù	defesa
防止	fáng zhǐ	evita
防治	fáng zhì	ao controle
纺织	fǎng zhī	têxtil
访问	fǎng wèn	acesso
放大	fàng dà	prolongar
放射	fàng shè	radiação
非法	fēi fǎ	ilegal
飞禽走兽	fēi qín zǒu shòu	pássaros e feras
飞翔	fēi xiáng	mosca
飞跃	fēi yuè	salto
肥沃	féi wò	fertil
诽谤	fěi bàng	difamação
废除	fèi chú	abolição
废寝忘食	fèi qǐn wàng shí	sem dormir
废墟	fèi xū	ruínas
沸腾	fèi téng	ebulição
肺	fèi	pulmão
分辨	fēn biàn	distinguir
分寸	fēn cun	a medida
分红	fēn hóng	dividendos
分解	fēn jiě	demolir
分裂	fēn liè	dividido
分泌	fēn mì	secreção
分明	fēn míng	distinto
分歧	fēn qí	desacordo
分散	fēn sàn	dispersão
吩咐	fēn fù	ordem
坟墓	fén mù	grave
粉末	fěn mò	pó
粉色	fěn sè	rosa
粉碎	fěn suì	esmagar
分量	fèn liàng	parte
愤怒	fèn nù	raiva
丰满	fēng mǎn	cheio
丰盛	fēng shèng	rico
丰收	fēng shōu	colheita abundante
封闭	fēng bì	fechadas
封建	fēng jiàn	feudal
封锁	fēng suǒ	bloqueio
锋利	fēng lì	afiado
风暴	fēng bào	tempestade
风度	fēng dù	comportamento
风光	fēng guāng	cenário
风气	fēng qì	atmosfera
风趣	fēng qù	engraçado
风土人情	fēng tǔ rén qíng	costumes locais
风味	fēng wèi	sabor
逢	féng	cada
奉献	fèng xiàn	dedicação
否决	fǒu jué	veto
夫妇	fū fù	casal
夫人	fū ren	senhora
敷衍	fū yǎn	superficial
俘虏	fú lǔ	cativo
幅度	fú dù	amplitude
服从	fú cóng	obedecer
服气	fú qì	convencido
福利	fú lì	bem-estar
福气	fú qi	bênção
符号	fú hào	símbolo
辐射	fú shè	radiação
俯视	fǔ shì	olhar para baixo
抚摸	fǔ mō	acariciando
抚养	fǔ yǎng	levantar
腐败	fǔ bài	corrupção
腐烂	fǔ làn	podridão
腐蚀	fǔ shí	corrosão
腐朽	fǔ xiǔ	decair
辅助	fǔ zhù	assist
副	fù	vício
复活	fù huó	ressurreição
复兴	fù xīng	renascimento
富裕	fù yù	rico
腹泻	fù xiè	diarréia
覆盖	fù gài	cobrir
负担	fù dān	fardo
赋予	fù yǔ	dar
附和	fù hè	acompanhar
附件	fù jiàn	anexo
附属	fù shǔ	em anexo
改良	gǎi liáng	melhorar
盖章	gài zhāng	carimbo
钙	gài	cálcio
尴尬	gān gà	desajeitado
干旱	gān hàn	seca
干扰	gān rǎo	interferência
干涉	gān shè	dizer a sua opinião
干预	gān yù	intervenção
感慨	gǎn kǎi	suspiro
感染	gǎn rǎn	infecção
干劲	gàn jìn	entusiasmo
扛	gāng	carregar
纲领	gāng lǐng	programa
岗位	gǎng wèi	postar
港口	gǎng kǒu	porta
港湾	gǎng wān	porto
杠杆	gàng gǎn	alavanca
高超	gāo chāo	soberbo
高潮	gāo cháo	clímax
高峰	gāo fēng	pico
高明	gāo míng	inteligente
高尚	gāo shàng	nobre
高涨	gāo zhǎng	subindo
稿件	gǎo jiàn	manuscrito
告辞	gào cí	despedida
告诫	gào jiè	admoestar
割	gē	cortar
搁	gē	colocar
歌颂	gē sòng	elogio
疙瘩	gē da	espinha
鸽子	gē zi	pombo
格局	gé jú	padronizar
格式	gé shì	formato
隔阂	gé hé	gap = vão
隔离	gé lí	isolamento
革命	gé mìng	revolução
个体	gè tǐ	individual
各抒己见	gè shū jǐ jiàn	expresse suas opiniões
根深蒂固	gēn shēn dì gù	arraigado
根源	gēn yuán	fonte
跟前	gēn qián	em frente de
跟随	gēn suí	segue
跟踪	gēn zōng	pista
更新	gēng xīn	atualizar
更正	gēng zhèng	corrigir
耕地	gēng dì	terra arável
供不应求	gōng bù yìng qiú	em falta
供给	gōng jǐ	fornecem
公安局	gōng ān jú	secretaria de segurança pública
公道	gōng dào	justiça
公告	gōng gào	anúncio
公关	gōng guān	pr
公民	gōng mín	cidadão
公然	gōng rán	abertamente
公认	gōng rèn	aceitaram
公式	gōng shì	fórmula
公务	gōng wù	negócio oficial
公正	gōng zhèng	somente
公证	gōng zhèng	notarização
功劳	gōng láo	crédito
功效	gōng xiào	efeito
宫殿	gōng diàn	palácio
工艺品	gōng yì pǐn	trabalhos manuais
恭敬	gōng jìng	respeitoso
攻击	gōng jī	ataque
攻克	gōng kè	capturar
巩固	gǒng gù	consolidar
共和国	gòng hé guó	república
共计	gòng jì	total
共鸣	gòng míng	ressonância
勾结	gōu jié	conluio
钩子	gōu zi	gancho
构思	gòu sī	idéia
姑且	gū qiě	provisoriamente
孤独	gū dú	solitário
孤立	gū lì	isolado
辜负	gū fù	decepcionar
古董	gǔ dǒng	antiguidade
古怪	gǔ guài	excêntrico
股东	gǔ dōng	acionista
股份	gǔ fèn	ações
骨干	gǔ gàn	espinha dorsal
鼓动	gǔ dòng	agitar
固然	gù rán	claro
固体	gù tǐ	sólido
固有	gù yǒu	inerente
固执	gù zhi	teimoso
故乡	gù xiāng	casa
故障	gù zhàng	defeituoso
雇佣	gù yōng	contratar
顾虑	gù lv4	preocupação
顾问	gù wèn	consultor
拐杖	guǎi zhàng	muleta
关怀	guān huái	cuidado
关照	guān zhào	cuidado
官方	guān fāng	oficial
观光	guān guāng	ir ver pontos turísticos
管辖	guǎn xiá	jurisdição
惯例	guàn lì	convenção
灌溉	guàn gài	irrigação
罐	guàn	tanque
贯彻	guàn chè	implemento
光彩	guāng cǎi	glorioso
光辉	guāng huī	glorioso
光芒	guāng máng	luz
光荣	guāng róng	glória
广阔	guǎng kuò	amplo
归根到底	guī gēn dào dǐ	na analise final
归还	guī huán	retorna
规范	guī fàn	especificação
规格	guī gé	especificação
规划	guī huà	planejamento
规章	guī zhāng	regulamentos
轨道	guǐ dào	pista
贵族	guì zú	nobre
跪	guì	ajoelhar
棍棒	gùn bàng	bastão
国防	guó fáng	defesa nacional
国务院	guó wù yuàn	conselho estadual
果断	guǒ duàn	decisivo
过度	guò dù	sobre
过渡	guò dù	transição
过奖	guò jiǎng	superestimado
过滤	guò lv4	filtro
过失	guò shī	culpa
过问	guò wèn	intervir
过瘾	guò yǐn	agradável
过于	guò yú	também
嗨	hāi	oi
海拔	hǎi bá	altitude
海滨	hǎi bīn	beira-mar
含糊	hán hu	vago
含义	hán yì	significado
寒暄	hán xuān	cumprimento
罕见	hǎn jiàn	raro
捍卫	hàn wèi	defender
航空	háng kōng	aviação
航天	háng tiān	aeroespacial
航行	háng xíng	navegando
行列	háng liè	ranks
毫米	háo mǐ	milímetros
毫无	háo wú	nada
豪迈	háo mài	heróico
号召	hào zhào	chamar para
耗费	hào fèi	custo
呵	hē	ah
合并	hé bìng	fundir
合成	hé chéng	síntese
合伙	hé huǒ	parceria
合算	hé suàn	custo-beneficio
和蔼	hé ǎi	tipo
和解	hé jiě	reconciliação
和睦	hé mù	harmonia
和气	hé qi	bondade
和谐	hé xié	harmonioso
嘿	hēi	ei
痕迹	hén jì	vestígio
狠心	hěn xīn	sem coração
恨不得	hèn bu dé	mal posso esperar
哼	hēng	humph
横	héng	horizontal
哄	hōng	persuadir
烘	hōng	assar
轰动	hōng dòng	sensação
宏观	hóng guān	macro
宏伟	hóng wěi	magnífico
洪水	hóng shuǐ	inundar
喉咙	hóu lóng	garganta
吼	hǒu	rugido
候选	hòu xuǎn	candidato
后代	hòu dài	descendência
后顾之忧	hòu gù zhī yōu	preocupações
后勤	hòu qín	logística
呼唤	hū huàn	ligar
呼啸	hū xiào	uivo
呼吁	hū yù	ligar
忽略	hū lvè	ignorar
湖泊	hú pō	lago
胡乱	hú luàn	casualmente
胡须	hú xū	barba
花瓣	huā bàn	pétala
花蕾	huā lěi	botão
华丽	huá lì	linda
华侨	huá qiáo	chinês estrangeiro
划分	huà fēn	dividir
化肥	huà féi	fertilizante
化石	huà shí	fóssil
化验	huà yàn	ensaio
化妆	huà zhuāng	maquiagem
画蛇添足	huà shé tiān zú	supérfluo
话筒	huà tǒng	microfone
欢乐	huān lè	alegria
环节	huán jié	ligação
还原	huán yuán	redução
缓和	huǎn hé	facilidade
患者	huàn zhě	paciente
荒凉	huāng liáng	desolado
荒谬	huāng miù	absurdo
荒唐	huāng táng	absurdo
皇帝	huáng dì	imperador
皇后	huáng hòu	rainha
黄昏	huáng hūn	crepúsculo
恍然大悟	huǎng rán dà wù	de repente percebi
晃	huǎng	mexe
挥霍	huī huò	fazer alarde
辉煌	huī huáng	brilhante
回报	huí bào	retorna
回避	huí bì	evitar
回顾	huí gù	reveja
回收	huí shōu	reciclar
悔恨	huǐ hèn	remorso
毁灭	huǐ miè	destruir
会晤	huì wù	encontro
汇报	huì bào	relatório
贿赂	huì lù	suborno
昏迷	hūn mí	coma
荤	hūn	carne
浑身	hún shēn	por toda parte
混合	hùn hé	mistura
混乱	hùn luàn	confusão
混淆	hùn xiáo	confundir
混浊	hùn zhuó	turvo
活该	huó gāi	merece
活力	huó lì	vitalidade
火箭	huǒ jiàn	foguete
火焰	huǒ yàn	chama
火药	huǒ yào	pólvora
货币	huò bì	moeda
基地	jī dì	base
基金	jī jīn	fundo
基因	jī yīn	gene
机动	jī dòng	manobra
机构	jī gòu	mecanismo
机灵	jī ling	inteligente
机密	jī mì	confidencial
机械	jī xiè	mecânico
机遇	jī yù	oportunidade
机智	jī zhì	espirituoso
激发	jī fā	excitação
激励	jī lì	excitação
激情	jī qíng	paixão
讥笑	jī xiào	zombaria
饥饿	jī è	fome
即便	jí biàn	mesmo se
即将	jí jiāng	em breve
及早	jí zǎo	cedo
吉祥	jí xiáng	auspicioso
嫉妒	jí dù	com ciumes
急功近利	jí gōng jìn lì	sucesso rápido
急剧	jí jù	afiado
急切	jí qiè	ansioso
急于求成	jí yú qiú chéng	ansioso para o sucesso
急躁	jí zào	impaciente
极端	jí duān	extremo
极限	jí xiàn	limite
疾病	jí bìng	doença
籍贯	jí guàn	cidade natal
级别	jí bié	nível
集团	jí tuán	grupo
给予	jǐ yǔ	dar
季军	jì jūn	terceiro lugar
季度	jì dù	trimestral
寂静	jì jìng	silêncio
寄托	jì tuō	confiar
忌讳	jì huì	tabu
技巧	jì qiǎo	habilidade
纪要	jì yào	resumo
继承	jì chéng	herdar
计较	jì jiào	se importar
记性	jì xing	memória
记载	jì zǎi	registro
迹象	jì xiàng	placa
佳肴	jiā yáo	delicadeza
加工	jiā gōng	em processamento
加剧	jiā jù	intensificar
夹杂	jiā zá	inclusão
家常	jiā cháng	caseira
家伙	jiā huo	cara
家属	jiā shǔ	membros da família
家喻户晓	jiā yù hù xiǎo	bem conhecido
坚定	jiān dìng	empresa
坚固	jiān gù	empresa
坚韧	jiān rèn	difícil
坚实	jiān shí	sólido
坚硬	jiān yìng	difícil
尖端	jiān duān	dica
尖锐	jiān ruì	afiado
煎	jiān	frito
监督	jiān dū	supervisionar
监视	jiān shì	monitor
监狱	jiān yù	prisão
艰难	jiān nán	difícil
剪彩	jiǎn cǎi	corte a fita
拣	jiǎn	escolher
检讨	jiǎn tǎo	reveja
检验	jiǎn yàn	teste
简化	jiǎn huà	simplificar
简陋	jiǎn lòu	bruto
简体字	jiǎn tǐ zì	chinês simplificado
简要	jiǎn yào	breve
健全	jiàn quán	som
剑	jiàn	espada
溅	jiàn	respingo
舰艇	jiàn tǐng	navio
见多识广	jiàn duō shí guǎng	bem informado
见解	jiàn jiě	opinião
见闻	jiàn wén	conhecimento
见义勇为	jiàn yì yǒng wéi	justificar
践踏	jiàn tà	atropelar
鉴别	jiàn bié	identificar
鉴定	jiàn dìng	identificação
鉴于	jiàn yú	dado
间谍	jiàn dié	espião
间隔	jiàn gé	intervalo
间接	jiàn jiē	indireto
僵硬	jiāng yìng	rígido
将军	jiāng jūn	geral
将近	jiāng jìn	por pouco
将就	jiāng jiù	será
奖励	jiǎng lì	recompensa
奖赏	jiǎng shǎng	recompensa
桨	jiǎng	remo
降临	jiàng lín	venha
交叉	jiāo chā	cruz
交代	jiāo dài	explicar
交涉	jiāo shè	negociação
交易	jiāo yì	transação
娇气	jiāo qì	melindroso
焦点	jiāo diǎn	foco
焦急	jiāo jí	ansioso
侥幸	jiǎo xìng	por sorte
搅拌	jiǎo bàn	mexer
缴纳	jiǎo nà	pagamento
角落	jiǎo luò	canto
教养	jiào yǎng	educação
较量	jiào liàng	concurso
接连	jiē lián	pegar
揭露	jiē lù	expor
皆	jiē	todos
阶层	jiē céng	classe
截止	jié zhǐ	corte fora
截至	jié zhì	a partir de
杰出	jié chū	excepcional
竭尽全力	jié jìn quán lì	faça o seu melhor
结晶	jié jīng	cristalização
结局	jié jú	final
结算	jié suàn	assentamento
节制	jié zhì	ao controle
节奏	jié zòu	ritmo
解除	jiě chú	dispensar
解放	jiě fàng	libertação
解雇	jiě gù	demissão
解剖	jiě pōu	anatomia
解散	jiě sàn	disband
解体	jiě tǐ	desintegração
借鉴	jiè jiàn	pedir emprestado
借助	jiè zhù	com a ajuda de
戒备	jiè bèi	alerta
界限	jiè xiàn	limite
津津有味	jīn jīn yǒu wèi	com prazer
金融	jīn róng	financeiro
紧迫	jǐn pò	urgente
锦上添花	jǐn shàng tiān huā	cobertura no bolo
晋升	jìn shēng	promoção
浸泡	jìn pào	absorver
近来	jìn lái	recentemente
进而	jìn ér	e depois
进攻	jìn gōng	ataque
进化	jìn huà	evolução
进展	jìn zhǎn	progresso
兢兢业业	jīng jīng yè yè	consciencioso
惊动	jīng dòng	perturbar
惊奇	jīng qí	surpresa
惊讶	jīng yà	surpreso
精打细算	jīng dǎ xì suàn	planeje cuidadosamente
精华	jīng huá	essência
精简	jīng jiǎn	linha de fluxo
精密	jīng mì	precisão
精确	jīng què	preciso
精通	jīng tōng	proficiente
精心	jīng xīn	elaborar
精益求精	jīng yì qiú jīng	continue melhorando
精致	jīng zhì	requintado
经费	jīng fèi	financiamento
经纬	jīng wěi	latitude e longitude
茎	jīng	haste
井	jǐng	bem
警告	jǐng gào	embargo
警惕	jǐng tì	alerta
颈椎	jǐng zhuī	espinha cervical
境界	jìng jiè	reino
敬礼	jìng lǐ	saudação
敬业	jìng yè	dedicada
竞赛	jìng sài	concorrência
竞选	jìng xuǎn	campanha
镜头	jìng tóu	lente
纠纷	jiū fēn	disputa
纠正	jiū zhèng	corrigir
酒精	jiǔ jīng	álcool
就近	jiù jìn	perto
就业	jiù yè	emprego
就职	jiù zhí	inauguração
救济	jiù jì	alívio
居民	jū mín	moradores
居住	jū zhù	viver
拘留	jū liú	detenção
拘束	jū shù	restrição
鞠躬	jū gōng	arco
局部	jú bù	parcial
局面	jú miàn	situação
局势	jú shì	situação
局限	jú xiàn	limitações
举动	jǔ dòng	mover
举世瞩目	jǔ shì zhǔ mù	atraia a atenção mundial
举足轻重	jǔ zú qīng zhòng	pivotal
咀嚼	jǔ jué	mastigar
沮丧	jǔ sàng	frustrado
剧本	jù běn	roteiro
剧烈	jù liè	forte
据悉	jù xī	é relatado que
聚精会神	jù jīng huì shén	concentrado
卷	juǎn	volume
倔强	jué jiàng	teimoso
决策	jué cè	tomando uma decisão
绝望	jué wàng	desespero
觉悟	jué wù	consciência
觉醒	jué xǐng	despertar
军队	jūn duì	exército
君子	jūn zǐ	cavalheiro
卡通	kǎ tōng	desenhos animados
开采	kāi cǎi	mineração
开除	kāi chú	expulso
开阔	kāi kuò	abrir
开朗	kāi lǎng	alegre
开明	kāi míng	iluminado
开辟	kāi pì	abra
开拓	kāi tuò	abra
开展	kāi zhǎn	desenvolve
开支	kāi zhī	despesa
刊登	kān dēng	publicar
刊物	kān wù	publicação
勘探	kān tàn	exploração
侃侃而谈	kǎn kǎn ér tán	fale livremente
砍伐	kǎn fá	me sentindo
看待	kàn dài	olhe para
慷慨	kāng kǎi	generoso
抗议	kàng yì	protesto
考察	kǎo chá	pesquisa
考古	kǎo gǔ	arqueologia
考核	kǎo hé	avaliação
考验	kǎo yàn	teste
靠拢	kào lǒng	aproxime-se
磕	kē	batida
科目	kē mù	sujeito
可观	kě guān	considerável
可口	kě kǒu	saboroso
可恶	kě wù	odioso
可行	kě xíng	factível
渴望	kě wàng	desejo
克制	kè zhì	restrição
刻不容缓	kè bù róng huǎn	sem tempo para atrasar
客户	kè hù	cliente
课题	kè tí	sujeito
啃	kěn	mordida
恳切	kěn qiè	sincero
坑	kēng	cova
空洞	kōng dòng	oco
空前绝后	kōng qián jué hòu	sem precedente
空想	kōng xiǎng	fantasia
空虚	kōng xū	vazio
孔	kǒng	orifício
恐怖	kǒng bù	terror
恐吓	kǒng hè	intimidar
恐惧	kǒng jù	medo
空白	kòng bái	em branco
空隙	kòng xì	gap = vão
口气	kǒu qì	tom
口腔	kǒu qiāng	cavidade oral
口头	kǒu tóu	oral
口音	kǒu yīn	sotaque
扣	kòu	fivela
哭泣	kū qì	choro
枯萎	kū wěi	murcha
枯燥	kū zào	maçante
苦尽甘来	kǔ jìn gān lái	amargura
苦涩	kǔ sè	amargo
挎	kuà	carregar
跨	kuà	período
快活	kuài huo	feliz
宽敞	kuān chang	espaçoso
宽容	kuān róng	tolerante
款待	kuǎn dài	hospitalidade
款式	kuǎn shì	estilo
筐	kuāng	cesta
况且	kuàng qiě	além de
旷课	kuàng kè	absentismo
框架	kuàng jià	quadro, armação
矿产	kuàng chǎn	mineral
亏待	kuī dài	tratar mal
亏损	kuī sǔn	perda
捆绑	kǔn bǎng	amarrado
扩充	kuò chōng	expansão
扩散	kuò sàn	difusão
扩张	kuò zhāng	expansão
啦	lā	la
喇叭	lǎ ba	alto falante
蜡烛	là zhú	vela
来历	lái lì	origem
来源	lái yuán	fonte
栏目	lán mù	coluna
懒惰	lǎn duò	preguiçoso
狼狈	láng bèi	envergonhado
狼吞虎咽	láng tūn hǔ yàn	lobo
捞	lāo	peixe
唠叨	láo dao	ranzinza
牢固	láo gù	empresa
牢骚	láo sāo	resmungar
乐趣	lè qù	prazer
乐意	lè yì	disposto
雷达	léi dá	radar
类似	lèi sì	semelhante
冷酷	lěng kù	cruel
冷落	lěng luò	abandonado
冷却	lěng què	esfriar
愣	lèng	congelada
黎明	lí míng	alvorecer
理睬	lǐ cǎi	prestar atenção em
理所当然	lǐ suǒ dāng rán	claro
理直气壮	lǐ zhí qì zhuàng	direto
理智	lǐ zhì	razão
礼节	lǐ jié	etiqueta
礼尚往来	lǐ shàng wǎng lái	reciprocidade
里程碑	lǐ chéng bēi	marco histórico
例外	lì wài	exceção
利害	lì hài	estaca
力求	lì qiú	esforçar-se para
力所能及	lì suǒ néng jí	dentro do nosso poder
力争	lì zhēng	esforce-se
历代	lì dài	história
历来	lì lái	sempre
立场	lì chǎng	posição
立方	lì fāng	cubo
立交桥	lì jiāo qiáo	ultrapassar
立体	lì tǐ	tridimensional
立足	lì zú	ficar em pé
粒	lì	grão
廉洁	lián jié	limpar \ limpo
联欢	lián huān	juntar
联络	lián luò	conexão
联盟	lián méng	aliança
联想	lián xiǎng	lenovo
连年	lián nián	ano após ano
连锁	lián suǒ	corrente
连同	lián tóng	junto com
良心	liáng xīn	consciência
晾	liàng	ar
谅解	liàng jiě	compreensão
辽阔	liáo kuò	grande
列举	liè jǔ	enumerar
临床	lín chuáng	clínico
淋	lín	chuveiro
吝啬	lìn sè	mesquinho
伶俐	líng lì	inteligente
凌晨	líng chén	de manhã cedo
灵感	líng gǎn	inspiração
灵魂	líng hún	alma
灵敏	líng mǐn	sensível
零星	líng xīng	esporádico
领会	lǐng huì	compreendo
领事馆	lǐng shì guǎn	consulado
领土	lǐng tǔ	território
领悟	lǐng wù	compreender
领先	lǐng xiān	conduzir
领袖	lǐng xiù	líder
溜	liū	escorregar
流浪	liú làng	errante
流露	liú lù	revelar
流氓	liú máng	vampiro
流通	liú tōng	circulação
留恋	liú liàn	nostalgia
留念	liú niàn	lembrança
留神	liú shén	cuidado
聋哑	lóng yǎ	surdo e mudo
隆重	lóng zhòng	grande
垄断	lǒng duàn	monopólio
笼罩	lǒng zhào	encoberto
搂	lǒu	abraço
炉灶	lú zào	fogão
轮船	lún chuán	navio a vapor
轮廓	lún kuò	contorno
轮胎	lún tāi	pneus
论坛	lùn tán	fórum
论证	lùn zhèng	argumento
啰唆	luō suo	irritante
络绎不绝	luò yì bù jué	fluxo interminável
落成	luò chéng	concluído
落实	luò shí	implemento
屡次	lv3 cì	repetidamente
履行	lv3 xíng	preencha
掠夺	lvè duó	pilhagem
嘛	ma	bem
麻痹	má bì	paralisia
麻木	má mù	dormência
麻醉	má zuì	anestesia
码头	mǎ tóu	cais
蚂蚁	mǎ yǐ	formiga
埋伏	mái fú	emboscada
埋没	mái mò	enterrado
埋葬	mái zàng	enterrar
脉搏	mài bó	pulso
迈	mài	degrau
埋怨	mán yuàn	reclamar
慢性	màn xìng	crônica
漫长	màn cháng	longo
漫画	màn huà	histórias em quadrinhos
蔓延	màn yán	propagação
忙碌	máng lù	ocupado
盲目	máng mù	cegamente
茫茫	máng máng	grande
茫然	máng rán	perdido
冒充	mào chōng	personificar
冒犯	mào fàn	ofender
茂盛	mào shèng	florescer
媒介	méi jiè	médio
枚	méi	peças
美观	měi guān	lindo
美满	měi mǎn	feliz
美妙	měi miào	maravilhoso
萌芽	méng yá	botão
猛烈	měng liè	violento
眯	mī	estrabismo
弥补	mí bǔ	maquiagem
弥漫	mí màn	difuso
谜语	mí yǔ	enigma
迷惑	mí huo	confundir
迷人	mí rén	encantador
迷信	mí xìn	superstição
密度	mì dù	densidade
密封	mì fēng	foca
棉花	mián hua	algodão
免得	miǎn de	para que
免疫	miǎn yì	imunidade
勉励	miǎn lì	incentive
勉强	miǎn qiǎng	relutantemente
面貌	miàn mào	cara
面子	miàn zi	cara
描绘	miáo huì	retratar
瞄准	miáo zhǔn	alvo
渺小	miǎo xiǎo	pequeno
藐视	miǎo shì	desprezo
灭亡	miè wáng	perecer
蔑视	miè shì	desprezo
民间	mín jiān	folk
民主	mín zhǔ	democracia
敏捷	mǐn jié	ágil
敏锐	mǐn ruì	perspicaz
名次	míng cì	ranking
名额	míng é	contingente
名副其实	míng fù qí shí	digno do nome
名誉	míng yù	reputação
明明	míng míng	obviamente
明智	míng zhì	sensato
命名	mìng míng	nome
摸索	mō suo	tateando
摩擦	mó cā	atrito
模范	mó fàn	modelo
模式	mó shì	modo
模型	mó xíng	modelo
磨合	mó hé	correr em
膜	mó	membrana
魔鬼	mó guǐ	diabo
魔术	mó shù	magia
抹杀	mǒ shā	obliterar
墨水儿	mò shuǐ r	tinta
莫名其妙	mò míng qí miào	desconcertante
默默	mò mò	silenciosamente
谋求	móu qiú	procurar
模样	mú yàng	aparência
母语	mǔ yǔ	língua nativa
沐浴	mù yù	banhar
目睹	mù dǔ	testemunha
目光	mù guāng	veja
拿手	ná shǒu	boa
纳闷儿	nà mèn r	perguntando
耐用	nài yòng	durável
南辕北辙	nán yuán běi zhé	divergente
难得	nán dé	raro
难堪	nán kān	envergonhado
难能可贵	nán néng kě guì	louvável
恼火	nǎo huǒ	aborrecido
内涵	nèi hán	conotação
内幕	nèi mù	história interna
内在	nèi zài	interior
能量	néng liàng	energia
拟定	nǐ dìng	desenhe
逆行	nì xíng	retrógrado
年度	nián dù	ano
捏	niē	pitada
凝固	níng gù	solidificação
凝聚	níng jù	coesão
凝视	níng shì	olhar
拧	níng	parafuso
宁肯	nìng kěn	em vez
宁愿	nìng yuàn	preferiria
扭转	niǔ zhuǎn	torção
纽扣儿	niǔ kòu r	botões
农历	nóng lì	calendário lunar
浓厚	nóng hòu	forte
奴隶	nú lì	escravo
挪	nuó	mover
虐待	nvè dài	abuso
哦	ò	oh
殴打	ōu dǎ	batida
偶像	ǒu xiàng	ídolo
呕吐	ǒu tù	vômito
趴	pā	mentira
徘徊	pái huái	errante
排斥	pái chì	repelir
排除	pái chú	excluir
排放	pái fàng	emissão
排练	pái liàn	ensaiar
派别	pài bié	facção
派遣	pài qiǎn	enviar
攀登	pān dēng	a escalada
盘旋	pán xuán	circulando
判决	pàn jué	julgamento
畔	pàn	banco
庞大	páng dà	enorme
抛弃	pāo qì	abandono
泡沫	pào mò	espuma
培育	péi yù	nutrir
配备	pèi bèi	equipado
配偶	pèi ǒu	cônjuge
配套	pèi tào	coincidindo
盆地	pén dì	bacia
烹饪	pēng rèn	cozinhando
捧	pěng	aguarde
劈	pī	hackear
批发	pī fā	atacado
批判	pī pàn	crítica
疲惫	pí bèi	exausta
疲倦	pí juàn	cansado
皮革	pí gé	couro
屁股	pì gu	bunda
譬如	pì rú	por exemplo
偏差	piān chā	desvio
偏见	piān jiàn	viés
偏僻	piān pì	controlo remoto
偏偏	piān piān	pelo contrário
片断	piàn duàn	fragmento
片刻	piàn kè	momento
漂浮	piāo fú	flutuador
飘扬	piāo yáng	flutter
撇	piē	skimming
拼搏	pīn bó	trabalho duro
拼命	pīn mìng	desesperadamente
贫乏	pín fá	pobre
贫困	pín kùn	pobre
频繁	pín fán	freqüentemente
频率	pín lv4	frequência
品尝	pǐn cháng	gosto
品德	pǐn dé	personagem
品质	pǐn zhì	qualidade
品种	pǐn zhǒng	variedade
屏幕	píng mù	tela
屏障	píng zhàng	barreira
平凡	píng fán	comum
平面	píng miàn	plano
平坦	píng tǎn	plano
平行	píng xíng	paralelo
平庸	píng yōng	medíocre
平原	píng yuán	avião
评估	píng gū	avaliação
评论	píng lùn	comente
坡	pō	declive
泼	pō	respingo
颇	pō	bastante
破例	pò lì	faça uma exceção
迫不及待	pò bù jí dài	mal posso esperar
迫害	pò hài	perseguição
魄力	pò lì	coragem
扑	pū	vibração
铺	pū	fazer compras
普及	pǔ jí	universal
朴实	pǔ shí	simples
朴素	pǔ sù	simples
瀑布	pù bù	cascata
凄凉	qī liáng	desolado
期望	qī wàng	espero
期限	qī xiàn	o termo
欺负	qī fu	valentão
欺骗	qī piàn	enganar
奇妙	qí miào	maravilhoso
旗袍	qí páo	cheongsam
旗帜	qí zhì	bandeira
歧视	qí shì	discriminação
齐全	qí quán	completo
齐心协力	qí xīn xié lì	trabalhar juntos
乞丐	qǐ gài	mendigo
企图	qǐ tú	tentativa
启程	qǐ chéng	zarpar, fugir
启蒙	qǐ méng	iluminação
启事	qǐ shì	aviso prévio
启示	qǐ shì	iluminação
岂有此理	qǐ yǒu cǐ lǐ	irracional
起草	qǐ cǎo	rascunho
起初	qǐ chū	no início
起伏	qǐ fú	altos e baixos
起哄	qǐ hòng	vaias
起码	qǐ mǎ	finalmente
起源	qǐ yuán	origem
器材	qì cái	equipamento
器官	qì guān	órgão
气概	qì gài	espírito
气功	qì gōng	qigong
气魄	qì pò	negrito
气色	qì sè	tez
气势	qì shì	impulso
气味	qì wèi	odor
气象	qì xiàng	meteorológico
气压	qì yā	pressão do ar
气质	qì zhí	temperamento
迄今为止	qì jīn wéi zhǐ	tão longe
掐	qiā	pitada
恰当	qià dàng	apropriado
恰到好处	qià dào hǎo chù	na medida
恰巧	qià qiǎo	coincidentemente
洽谈	qià tán	negociar
千方百计	qiān fāng bǎi jì	faça todo o possível
牵	qiān	conduzir
牵扯	qiān chě	envolver
牵制	qiān zhì	conter
签署	qiān shǔ	placa
谦逊	qiān xùn	humilde
迁就	qiān jiù	acomodar
迁徙	qiān xǐ	migração
前景	qián jǐng	perspectiva
前提	qián tí	premissa
潜力	qián lì	potencial
潜水	qián shuǐ	mergulho
潜移默化	qián yí mò huà	imperceptivelmente
谴责	qiǎn zé	condenar
抢劫	qiāng jié	roubo
强制	qiáng zhì	obrigatório
强迫	qiǎng pò	força
抢救	qiǎng jiù	resgate
桥梁	qiáo liáng	ponte
窍门	qiào mén	truque
翘	qiào	alice
切实	qiè shí	prático
锲而不舍	qiè ér bù shě	perseverança
亲密	qīn mì	fechar
亲热	qīn rè	afetuoso
侵犯	qīn fàn	violar
侵略	qīn lvè	agressão
钦佩	qīn pèi	admiração
勤俭	qín jiǎn	trabalha duro
勤劳	qín láo	trabalhador
倾听	qīng tīng	ouço
倾向	qīng xiàng	tendência
倾斜	qīng xié	inclinar
清澈	qīng chè	claro
清晨	qīng chén	de manhã cedo
清除	qīng chú	claro
清洁	qīng jié	limpar \ limpo
清理	qīng lǐ	limpar
清晰	qīng xī	claro
清醒	qīng xǐng	totalmente acordado
清真	qīng zhēn	muçulmano
情报	qíng bào	inteligência
情节	qíng jié	enredo
情理	qíng lǐ	sentido
情形	qíng xíng	situação
晴朗	qíng lǎng	ensolarado
请柬	qǐng jiǎn	convite
请教	qǐng jiào	consultar
请示	qǐng shì	peça instruções
请帖	qǐng tiě	convite
丘陵	qiū líng	colinas
区分	qū fēn	distinguir
区域	qū yù	área
屈服	qū fú	produção
曲折	qū zhé	tortuoso
驱逐	qū zhú	expulsar
渠道	qú dào	canal
取缔	qǔ dì	banimento
曲子	qǔ zi	canção
趣味	qù wèi	gosto
圈套	quān tào	armadilha
全局	quán jú	global
全力以赴	quán lì yǐ fù	fazer o seu melhor
拳头	quán tou	punho
权衡	quán héng	troca
权威	quán wēi	autoridade
犬	quǎn	cão
缺口	quē kǒu	gap = vão
缺席	quē xí	ausência
缺陷	quē xiàn	defeito
瘸	qué	coxo
确保	què bǎo	certificar-se de que
确立	què lì	estabelecer
确切	què qiè	exato
确信	què xìn	convencido
群众	qún zhòng	as massas
染	rǎn	tintura
嚷	rǎng	gritar
让步	ràng bù	concessão
饶恕	ráo shù	perdoar
扰乱	rǎo luàn	perturbar
惹祸	rě huò	desastre do tribunal
热泪盈眶	rè lèi yíng kuàng	lágrimas nos olhos
热门	rè mén	popular
人道	rén dào	humano
人格	rén gé	personalidade
人工	rén gōng	artificial
人家	rén jia	pessoas
人间	rén jiān	mundo
人士	rén shì	pessoa
人为	rén wéi	artificial
人性	rén xìng	natureza humana
人质	rén zhì	refém
仁慈	rén cí	bondade
忍耐	rěn nài	paciência
忍受	rěn shòu	suportar
任命	rèn mìng	compromisso
任性	rèn xìng	caprichoso
任意	rèn yì	arbitrário
任重道远	rèn zhòng dào yuǎn	um longo caminho a percorrer
认定	rèn dìng	reconhecer
认可	rèn kě	reconhecido
仍旧	réng jiù	ainda
日新月异	rì xīn yuè yì	mudando a cada dia que passa
日益	rì yì	cada vez mais
容貌	róng mào	aparência
容纳	róng nà	acomodar
容器	róng qì	recipiente
容忍	róng rěn	tolerar
溶解	róng jiě	dissolver
荣幸	róng xìng	com prazer
荣誉	róng yù	honra
融化	róng huà	fundição
融洽	róng qià	rapport
揉	róu	esfregar
柔和	róu hé	suave
儒家	rú jiā	confucionismo
弱点	ruò diǎn	fraqueza
若干	ruò gān	de várias
撒谎	sā huǎng	mentira
散文	sǎn wén	prosa
散布	sàn bù	propagação
散发	sàn fā	distribuir
丧失	sàng shī	perder
骚扰	sāo rǎo	molestar
嫂子	sǎo zi	cunhada
刹车	shā chē	freio
啥	shá	o que
筛选	shāi xuǎn	filtro
山脉	shān mài	montanhas
闪烁	shǎn shuò	piscando
擅长	shàn cháng	bom em
擅自	shàn zì	não autorizado
伤脑筋	shāng nǎo jīn	problemático
商标	shāng biāo	marca comercial
上级	shàng jí	superior
上进	shàng jìn	motivar
上任	shàng rèn	assumir o cargo
上瘾	shàng yǐn	viciado
上游	shàng yóu	rio acima
尚且	shàng qiě	ainda
捎	shāo	levar
梢	shāo	dica
哨	shào	postar
奢侈	shē chǐ	luxo
舌头	shé tou	língua
摄氏度	shè shì dù	celsius
涉及	shè jí	envolvido
社区	shè qū	comunidade
设立	shè lì	configuração
设想	shè xiǎng	imagine
设置	shè zhì	configuração
呻吟	shēn yín	gemido
深奥	shēn ào	profundo
深沉	shēn chén	profundo
深情厚谊	shēn qíng hòu yì	amizade profunda
申报	shēn bào	declarar
绅士	shēn shì	cavalheiro
神经	shén jīng	nervo
神奇	shén qí	mágico
神气	shén qì	ar
神圣	shén shèng	sagrado
神态	shén tài	comportamento
神仙	shén xiān	imortal
审查	shěn chá	reveja
审理	shěn lǐ	tentativas
审美	shěn měi	estético
审判	shěn pàn	tentativas
慎重	shèn zhòng	cuidado
渗透	shèn tòu	penetração
声明	shēng míng	declaração
声势	shēng shì	momentum
声誉	shēng yù	reputação
牲畜	shēng chù	gado
生存	shēng cún	sobreviver
生机	shēng jī	vitalidade
生理	shēng lǐ	fisiológico
生疏	shēng shū	oxidado
生态	shēng tài	ecologia
生物	shēng wù	biológico
生效	shēng xiào	surtir efeito
生肖	shēng xiào	zodíaco
生锈	shēng xiù	ferrugem
生育	shēng yù	fertilidade
省会	shěng huì	capital provincial
盛产	shèng chǎn	rico
盛开	shèng kāi	flor
盛情	shèng qíng	hospitalidade
盛行	shèng xíng	prevalecer
胜负	shèng fù	ganhar ou perder
失事	shī shì	destruir
失误	shī wù	erro
失踪	shī zōng	ausência de
尸体	shī tǐ	corpo morto
师范	shī fàn	professor
施加	shī jiā	impor
施展	shī zhǎn	exibição
十足	shí zú	cheio
实惠	shí huì	acessível
实力	shí lì	força
实施	shí shī	implemento
实事求是	shí shì qiú shì	procure a verdade dos fatos
实行	shí xíng	implemento
实质	shí zhì	substância
拾	shí	pegar
时常	shí cháng	frequentemente
时而	shí ér	as vezes
时光	shí guāng	tempo
时机	shí jī	oportunidade
时事	shí shì	eventos atuais
石油	shí yóu	óleo
识别	shí bié	identificar
使命	shǐ mìng	missão
世代	shì dài	gerações
事故	shì gù	acidente
事迹	shì jì	atos
事件	shì jiàn	evento
事态	shì tài	situação
事务	shì wù	romances
事项	shì xiàng	importam
事业	shì yè	causa
势必	shì bì	vinculado a
势力	shì li	poder
是非	shì fēi	certo ou errado
示范	shì fàn	demonstração
示威	shì wēi	demonstração
示意	shì yì	sinal
视力	shì lì	visão
视频	shì pín	vídeo
视线	shì xiàn	vista
视野	shì yě	visão
试图	shì tú	tentativa
试验	shì yàn	teste
适宜	shì yí	adequado
逝世	shì shì	falecer
释放	shì fàng	libertado
收藏	shōu cáng	favoritos
收缩	shōu suō	encolher
收益	shōu yì	renda
收音机	shōu yīn jī	rádio
守护	shǒu hù	guarda
手法	shǒu fǎ	técnica
手势	shǒu shì	gesto
手艺	shǒu yì	construir
首饰	shǒu shì	joalheria
首要	shǒu yào	primário
受罪	shòu zuì	sofra
授予	shòu yǔ	conceder
书法	shū fǎ	caligrafia
书记	shū ji	secretário
书籍	shū jí	livros
书面	shū miàn	escrito
疏忽	shū hu	negligência
疏远	shū yuǎn	alienar
舒畅	shū chàng	confortável
数额	shù é	montante
束	shù	agrupar
束缚	shù fù	escravidão
树立	shù lì	configuração
竖	shù	vertical
耍	shuǎ	jogar
衰老	shuāi lǎo	senescência
衰退	shuāi tuì	declínio
率领	shuài lǐng	conduzir
涮火锅	shuàn huǒ guō	shabu-shabu
双胞胎	shuāng bāo tāi	gêmeo
爽快	shuǎng kuài	prontamente
水利	shuǐ lì	conservação de água
水龙头	shuǐ lóng tóu	torneira
水泥	shuǐ ní	cimento
瞬间	shùn jiān	momento
司法	sī fǎ	judicial
司令	sī lìng	comandante
思念	sī niàn	senhorita
思索	sī suǒ	pensando
思维	sī wéi	pensando
斯文	sī wen	□ gentil
私自	sī zì	em privado
死亡	sǐ wáng	morte
四肢	sì zhī	membros
寺庙	sì miào	têmpora
肆无忌惮	sì wú jì dàn	sem escrúpulos
饲养	sì yǎng	recria
耸	sǒng	imponente
艘	sōu	navio
苏醒	sū xǐng	despertar
俗话	sú huà	calão
塑造	sù zào	forma
素食	sù shí	comida vegetariana
素质	sù zhì	qualidade
诉讼	sù sòng	litígio
算数	suàn shù	contagem
随即	suí jí	imediatamente
随意	suí yì	aleatória
岁月	suì yuè	anos
隧道	suì dào	túnel
损坏	sǔn huài	danificar
索取	suǒ qǔ	solicitação
索性	suǒ xìng	simplesmente
塌	tā	colapso
踏实	tā shi	firme
塔	tǎ	torre
台风	tái fēng	tufão
太空	tài kōng	espaço
泰斗	tài dǒu	reitor
摊	tān	impedir
瘫痪	tān huàn	paralisia
贪婪	tān lán	ávido
贪污	tān wū	corrupção
弹性	tán xìng	elasticidade
坦白	tǎn bái	franco
叹气	tàn qì	suspiro
探测	tàn cè	detectar
探索	tàn suǒ	explorar
探讨	tàn tǎo	explorar
探望	tàn wàng	visita
倘若	tǎng ruò	e se
掏	tāo	escavação
滔滔不绝	tāo tāo bù jué	fale sem parar
淘汰	táo tài	eliminado
陶瓷	táo cí	cerâmica
陶醉	táo zuì	festa
讨好	tǎo hǎo	por favor
特长	tè cháng	especialidade
特定	tè dìng	específico
特意	tè yì	especialmente
提拔	tí bá	promovido
提炼	tí liàn	refinação
提示	tí shì	pronto
提议	tí yì	proposta
题材	tí cái	tema
体裁	tǐ cái	gênero
体积	tǐ jī	volume
体谅	tǐ liàng	atencioso
体面	tǐ miàn	decente
体系	tǐ xì	sistema
天才	tiān cái	gênio
天赋	tiān fù	talento
天伦之乐	tiān lún zhī lè	diversão familiar
天然气	tiān rán qì	gás natural
天生	tiān shēng	nascermos
天堂	tiān táng	céu
天文	tiān wén	astronômico
田径	tián jìng	atletismo
田野	tián yě	campo
舔	tiǎn	lamber
挑剔	tiāo ti	exigente
条款	tiáo kuǎn	termos
条理	tiáo lǐ	organizado
条约	tiáo yuē	tratado
调和	tiáo hé	conciliar
调剂	tiáo jì	ajustar
调节	tiáo jié	ajustar
调解	tiáo jiě	mediação
调料	tiáo liào	tempero
挑拨	tiǎo bō	pague
挑衅	tiǎo xìn	provocante
跳跃	tiào yuè	saltar
亭子	tíng zi	pavilhão
停泊	tíng bó	estacionado
停顿	tíng dùn	pausa
停滞	tíng zhì	estagnado
挺拔	tǐng bá	alto e reto
通货膨胀	tōng huò péng zhàng	inflação
通缉	tōng jī	procurado
通俗	tōng sú	popular
通讯	tōng xùn	comunicação
通用	tōng yòng	universal
同胞	tóng bāo	irmão
同志	tóng zhì	gay
童话	tóng huà	conto de fadas
铜	tóng	cobre
统筹兼顾	tǒng chóu jiān gù	planejamento geral
统计	tǒng jì	estatisticas
统统	tǒng tǒng	todos
统治	tǒng zhì	regra
投机	tóu jī	especulação
投票	tóu piào	voto
投诉	tóu sù	queixa
投降	tóu xiáng	entrega
投掷	tóu zhì	lançar
透露	tòu lù	divulgar
秃	tū	careca
突破	tū pò	descoberta
图案	tú àn	padronizar
徒弟	tú dì	aprendiz
涂抹	tú mǒ	esfregar
途径	tú jìng	maneira
土壤	tǔ rǎng	solo
团结	tuán jié	unidade
团体	tuán tǐ	grupo
团圆	tuán yuán	reunião
推测	tuī cè	especular
推翻	tuī fān	derrubar
推理	tuī lǐ	raciocínio
推论	tuī lùn	inferência
推销	tuī xiāo	vender
吞吞吐吐	tūn tūn tǔ tǔ	hesitando
托运	tuō yùn	consignar
拖延	tuō yán	procrastinação
脱离	tuō lí	fugir
妥当	tuǒ dang	apropriado
妥善	tuǒ shàn	apropriado
妥协	tuǒ xié	compromisso
椭圆	tuǒ yuán	oval
唾弃	tuò qì	deixar de lado
哇	wa	uau
挖掘	wā jué	escavação
娃娃	wá wa	boneca
瓦解	wǎ jiě	colapso
歪曲	wāi qū	distorcer
外表	wài biǎo	aparência
外行	wài háng	leigo
外界	wài jiè	mundo exterior
外向	wài xiàng	extrovertido
丸	wán	comprimido
完备	wán bèi	completo
完毕	wán bì	completo
玩弄	wán nòng	toque
玩意儿	wán yì r	coisa
顽固	wán gù	teimoso
顽强	wán qiáng	persistente
惋惜	wǎn xī	arrepender
挽回	wǎn huí	resgatar
挽救	wǎn jiù	salve 
万分	wàn fēn	extremamente
往常	wǎng cháng	como sempre
往事	wǎng shì	passado
妄想	wàng xiǎng	ilusão
危机	wēi jī	crise
威风	wēi fēng	prestígio
威力	wēi lì	poder
威望	wēi wàng	prestígio
威信	wēi xìn	prestígio
微不足道	wēi bù zú dào	insignificante
微观	wēi guān	micro
为难	wéi nán	envergonhado
为期	wéi qī	duração
唯独	wéi dú	sozinho
维持	wéi chí	manter
维护	wéi hù	manter
维生素	wéi shēng sù	vitaminas
违背	wéi bèi	ir contra
伪造	wěi zào	falsificação
委托	wěi tuō	comissão
委员	wěi yuán	membro do comitê
卫星	wèi xīng	satélite
喂	wèi	olá (verbo)
慰问	wèi wèn	condolências
未免	wèi miǎn	inevitável
畏惧	wèi jù	medo
蔚蓝	wèi lán	azure
温带	wēn dài	zona temperada
温和	wēn hé	leve
文凭	wén píng	diploma
文物	wén wù	relíquias culturais
文献	wén xiàn	literatura
文雅	wén yǎ	elegante
文艺	wén yì	arte
问世	wèn shì	sair
窝	wō	ninho
乌黑	wū hēi	azeviche
污蔑	wū miè	calúnia
诬陷	wū xiàn	quadro, armação
无比	wú bǐ	extremamente
无偿	wú cháng	livre
无耻	wú chǐ	desavergonhado
无动于衷	wú dòng yú zhōng	indiferente
无非	wú fēi	nada mais que
无辜	wú gū	inocente
无精打采	wú jīng dǎ cǎi	apático
无赖	wú lài	vampiro
无理取闹	wú lǐ qǔ nào	irracional
无能为力	wú néng wéi lì	impotente
无穷无尽	wú qióng wú jìn	sem fim
无微不至	wú wēi bù zhì	meticuloso
无忧无虑	wú yōu wú lv4	despreocupado
无知	wú zhī	ignorância
侮辱	wǔ rǔ	insulto
武器	wǔ qì	braços
武侠	wǔ xiá	artes marciais
武装	wǔ zhuāng	armado
舞蹈	wǔ dǎo	dança
务必	wù bì	tenha certeza
物美价廉	wù měi jià lián	boa qualidade e barato
物业	wù yè	propriedade
物资	wù zī	suprimentos
误差	wù chā	erro
误解	wù jiě	mal entendido
夕阳	xī yáng	sunset
昔日	xī rì	velhos tempos
溪	xī	riacho
熄灭	xī miè	saia
牺牲	xī shēng	sacrifício
膝盖	xī gài	joelho
习俗	xí sú	personalizadas
媳妇	xí fu	nora
袭击	xí jī	assalto
喜闻乐见	xǐ wén lè jiàn	amo ouvir
喜悦	xǐ yuè	alegria
系列	xì liè	series
细菌	xì jūn	bacteriano
细胞	xì bāo	célula
细致	xì zhì	meticuloso
峡谷	xiá gǔ	canyon
狭隘	xiá ài	limitar
狭窄	xiá zhǎi	limitar
霞	xiá	xia
下属	xià shǔ	subordinar
先进	xiān jìn	avançado
先前	xiān qián	anteriormente
掀起	xiān qǐ	zarpar, fugir
纤维	xiān wéi	fibra
鲜明	xiān míng	brilhante
嫌	xián	não gosto
嫌疑	xián yí	suspeito
弦	xián	corda
衔接	xián jiē	conexão
贤惠	xián huì	virtuoso
闲话	xián huà	fofoca
显著	xiǎn zhù	significativo
宪法	xiàn fǎ	constituição
现场	xiàn chǎng	no local
现成	xiàn chéng	pronto
现状	xiàn zhuàng	status quo
线索	xiàn suǒ	pista
陷害	xiàn hài	emoldurado
陷阱	xiàn jǐng	armadilha
陷入	xiàn rù	cair em
馅儿	xiàn r	estofamento
乡镇	xiāng zhèn	township
相差	xiāng chà	diferença
相等	xiāng děng	igual
相辅相成	xiāng fǔ xiāng chéng	se completam
相应	xiāng yìng	correspondente
镶嵌	xiāng qiàn	mosaico
响亮	xiǎng liàng	alto
响应	xiǎng yìng	resposta
想方设法	xiǎng fāng shè fǎ	encontre caminhos
向导	xiàng dǎo	guia
向来	xiàng lái	sempre
向往	xiàng wǎng	ansiar por
巷	xiàng	faixa
相声	xiàng sheng	diafonia
消除	xiāo chú	eliminar
消毒	xiāo dú	desinfetar
消防	xiāo fáng	combate a incêndio
消耗	xiāo hào	consumir
消灭	xiāo miè	destrua
潇洒	xiāo sǎ	chique
销毁	xiāo huǐ	destruir
小心翼翼	xiǎo xīn yì yì	cautelosamente
效益	xiào yì	beneficiar
肖像	xiào xiàng	retrato
协会	xié huì	associação
协商	xié shāng	negociar
协调	xié tiáo	coordenação
协议	xié yì	protocolo
协助	xié zhù	ajudar
携带	xié dài	carregar
屑	xiè	migalhas
泄露	xiè lù	ceder
泄气	xiè qì	desanimado
谢绝	xiè jué	declínio
心得	xīn dé	experiência
心甘情愿	xīn gān qíng yuàn	de boa vontade
心灵	xīn líng	alma
心态	xīn tài	mentalidade
心疼	xīn téng	angustiado
心血	xīn xuè	trabalho duro
心眼儿	xīn yǎn r	atento
新陈代谢	xīn chén dài xiè	metabolismo
新郎	xīn láng	noivo
新娘	xīn niáng	noiva
新颖	xīn yǐng	romance
欣慰	xīn wèi	gratificado
欣欣向荣	xīn xīn xiàng róng	próspera
薪水	xīn shuǐ	salário
辛勤	xīn qín	trabalho duro
信赖	xìn lài	confiar em
信念	xìn niàn	crença
信仰	xìn yǎng	fé
信誉	xìn yù	reputação
兴高采烈	xīng gāo cǎi liè	exaltado
兴隆	xīng lóng	próspero
兴旺	xīng wàng	próspera
腥	xīng	duvidoso
刑事	xíng shì	criminoso
形态	xíng tài	formato
行政	xíng zhèng	administrativo
兴致勃勃	xìng zhì bó bó	animado
性感	xìng gǎn	sexy
性命	xìng mìng	vida
性能	xìng néng	desempenho
凶恶	xiōng è	vicioso
凶手	xiōng shǒu	assassino
汹涌	xiōng yǒng	turbulento
胸怀	xiōng huái	mente
胸膛	xiōng táng	peito
雄厚	xióng hòu	forte
雄伟	xióng wěi	majestoso
修复	xiū fù	reparar
修建	xiū jiàn	construir
修养	xiū yǎng	treinamento
羞耻	xiū chǐ	vergonha
嗅觉	xiù jué	cheiro
绣	xiù	bordar
虚假	xū jiǎ	falso
虚荣	xū róng	vaidade
虚伪	xū wěi	hipócrita
需求	xū qiú	exigem
须知	xū zhī	aviso prévio
许可	xǔ kě	licença
序言	xù yán	prefácio
畜牧	xù mù	criação animal
酗酒	xù jiǔ	alcoolismo
喧哗	xuān huá	tumulto
宣誓	xuān shì	prestar juramento
宣扬	xuān yáng	pregar
悬挂	xuán guà	suspensão
悬念	xuán niàn	suspense
悬殊	xuán shū	disparidade
悬崖峭壁	xuán yá qiào bì	falésias
旋律	xuán lv4	melodia
旋转	xuán zhuǎn	girar
选拔	xuǎn bá	seleção
选举	xuǎn jǔ	eleição
选手	xuǎn shǒu	jogador
炫耀	xuàn yào	mostrar
削	xuē	cortar
削弱	xuē ruò	enfraquecer
学说	xué shuō	teoria
学位	xué wèi	bacharel de ciência
雪上加霜	xuě shàng jiā shuāng	pior
血压	xuè yā	pressão arterial
熏陶	xūn táo	edificar
寻觅	xún mì	encontrar
巡逻	xún luó	patrulha
循环	xún huán	ciclo
循序渐进	xún xù jiàn jìn	passo a passo
压迫	yā pò	opressão
压岁钱	yā suì qián	dinheiro de ano novo
压缩	yā suō	compressão
压抑	yā yì	depressivo
压榨	yā zhà	pressione
压制	yā zhì	suprimir
鸦雀无声	yā què wú shēng	silencioso
亚军	yà jūn	vice-campeão
淹没	yān mò	submerso
烟花爆竹	yān huā bào zhú	fogos de artifício
严峻	yán jùn	forte
严寒	yán hán	frio severo
严禁	yán jìn	estritamente proibido
严厉	yán lì	forte
严密	yán mì	justa
岩石	yán shí	rocha
延期	yán qī	extensão
延伸	yán shēn	ampliar
延续	yán xù	continuar
沿海	yán hǎi	costeiro
炎热	yán rè	quente
言论	yán lùn	discurso
掩盖	yǎn gài	cobrir
掩护	yǎn hù	cobrir
掩饰	yǎn shì	cobrir
演变	yǎn biàn	evolução
演习	yǎn xí	exercício
演绎	yǎn yì	dedução
演奏	yǎn zòu	jogando
眼光	yǎn guāng	visão
眼色	yǎn sè	piscadela
眼神	yǎn shén	veja
厌恶	yàn wù	nojo
验收	yàn shōu	aceitação
验证	yàn zhèng	verificação
氧气	yǎng qì	oxigênio
样品	yàng pǐn	amostra
摇摆	yáo bǎi	balanço
摇滚	yáo gǔn	rocha
谣言	yáo yán	boato
遥控	yáo kòng	controle remoto
遥远	yáo yuǎn	distante
耀眼	yào yǎn	deslumbrante
要点	yào diǎn	ponto
要命	yào mìng	terrível
要素	yào sù	elemento
野蛮	yě mán	brutal
野心	yě xīn	ambição
液体	yè tǐ	líquido
一流	yī liú	primeira classe
一如既往	yī rú jì wǎng	como sempre
依旧	yī jiù	ainda
依据	yī jù	em concordância com
依靠	yī kào	contar com
依赖	yī lài	contar com
依托	yī tuō	dependem
衣裳	yī shang	roupas
一度	yí dù	um tempo
一贯	yí guàn	consistente
一目了然	yí mù liǎo rán	num relance
一向	yí xiàng	sempre
仪器	yí qì	instrumento
仪式	yí shì	cerimônia
疑惑	yí huò	dúvida
遗产	yí chǎn	herança
遗传	yí chuán	genético
遗留	yí liú	legado
遗失	yí shī	perdido
以便	yǐ biàn	de modo a
以免	yǐ miǎn	de modo a nao
以往	yǐ wǎng	no passado
以至	yǐ zhì	até
以致	yǐ zhì	de modo a
一帆风顺	yì fān fēng shùn	navegação suave
一举两得	yì jǔ liǎng dé	matar dois coelhos com uma cajadada só
一丝不苟	yì sī bù gǒu	meticuloso
亦	yì	além disso
异常	yì cháng	anormal
意料	yì liào	esperado
意识	yì shí	consciência
意图	yì tú	intenção
意味着	yì wèi zhe	significar
意向	yì xiàng	intenção
意志	yì zhì	vai
毅力	yì lì	perseverança
毅然	yì rán	decididamente
翼	yì	asa
阴谋	yīn móu	conspiração
音响	yīn xiǎng	som
引导	yǐn dǎo	guia
引擎	yǐn qíng	motor
引用	yǐn yòng	citar
隐蔽	yǐn bì	escondido
隐患	yǐn huàn	perigo escondido
隐瞒	yǐn mán	ocultar
隐私	yǐn sī	privacidade
隐约	yǐn yuē	desmaiar
饮食	yǐn shí	dieta
婴儿	yīng ér	bebê
英明	yīng míng	sensato
英勇	yīng yǒng	heróico
盈利	yíng lì	lucro
迎面	yíng miàn	de cabeça erguida
应酬	yìng chou	socializar
应邀	yìng yāo	ser convidado
庸俗	yōng sú	vulgar
拥护	yōng hù	apoio, suporte
拥有	yōng yǒu	ter
勇于	yǒng yú	bravo
永恒	yǒng héng	eterno
涌现	yǒng xiàn	emerge
踊跃	yǒng yuè	ativamente
用户	yòng hù	do utilizador
优胜劣汰	yōu shèng liè tài	sobrevivência do mais forte
优先	yōu xiān	prioridade
优异	yōu yì	excelente
优越	yōu yuè	superior
忧郁	yōu yù	melancólico
油腻	yóu nì	gorduroso
油漆	yóu qī	pintura
犹如	yóu rú	até parece
有条不紊	yǒu tiáo bù wěn	metódico
幼稚	yòu zhì	ingênuo
诱惑	yòu huò	em tentação
愚蠢	yú chǔn	boba
愚昧	yú mèi	ignorância
渔民	yú mín	pescadores
舆论	yú lùn	opinião pública
与日俱增	yǔ rì jù zēng	aumentando dia a dia
宇宙	yǔ zhòu	universo
羽绒服	yǔ róng fú	casaco de penas
寓言	yù yán	fábula
愈	yù	curar
欲望	yù wàng	desejo
熨	yù	passar roupa
玉	yù	jade
预料	yù liào	esperado
预期	yù qī	esperado
预算	yù suàn	despesas
预先	yù xiān	avançar
预言	yù yán	profecia
预兆	yù zhào	presságio
冤枉	yuān wang	errado
元首	yuán shǒu	chefe de estado
元素	yuán sù	elemento
元宵节	yuán xiāo jié	festival das lanternas
原告	yuán gào	demandante
原理	yuán lǐ	princípio
原始	yuán shǐ	original
原先	yuán xiān	original
园林	yuán lín	jardim
圆满	yuán mǎn	completo
源泉	yuán quán	fonte
缘故	yuán gù	razão
约束	yuē shù	restrição
乐谱	yuè pǔ	partitura
岳母	yuè mǔ	sogra
孕育	yùn yù	criado
蕴藏	yùn cáng	conter
运算	yùn suàn	cálculo
运行	yùn xíng	corre
酝酿	yùn niàng	fermentação
杂技	zá jì	acrobacia
杂交	zá jiāo	hibridização
砸	zá	esmagar
咋	zǎ	como
栽培	zāi péi	cultivo
灾难	zāi nàn	desastre
宰	zǎi	massacre
再接再厉	zài jiē zài lì	faça esforços persistentes
在意	zài yì	cuidado
攒	zǎn	salve 
暂且	zàn qiě	por enquanto
赞叹	zàn tàn	admirar
赞助	zàn zhù	patrocinador
糟蹋	zāo tà	estragar
遭受	zāo shòu	sofra
遭殃	zāo yāng	sofra
遭遇	zāo yù	encontro
噪音	zào yīn	barulho
造型	zào xíng	modelagem
责怪	zé guài	culpa
贼	zéi	ladrao
增添	zēng tiān	adicionar
赠送	zèng sòng	doar
扎	zhā	gravata
扎实	zhā shi	sólido
渣	zhā	escória
眨	zhǎ	piscar
诈骗	zhà piàn	fraude
摘要	zhāi yào	resumo
债券	zhài quàn	vinculo
沾光	zhān guāng	mergulho
瞻仰	zhān yǎng	pagar tributo a
展示	zhǎn shì	mostrar
展望	zhǎn wàng	outlook
展现	zhǎn xiàn	mostrar
崭新	zhǎn xīn	novo em folha
斩钉截铁	zhǎn dīng jié tiě	decisivamente
占据	zhàn jù	ocupar
占领	zhàn lǐng	ocupado
战斗	zhàn dòu	brigando
战略	zhàn lvè	estratégia
战术	zhàn shù	táticas
战役	zhàn yì	batalha
章程	zhāng chéng	carta
帐篷	zhàng peng	barraca
障碍	zhàng ài	obstáculo
招标	zhāo biāo	licitação
招收	zhāo shōu	recrutar
朝气蓬勃	zhāo qì péng bó	vigoroso
着迷	zháo mí	fascinado
沼泽	zhǎo zé	pântano
照样	zhào yàng	ainda
照耀	zhào yào	brilho
折腾	zhē teng	sorteio
遮挡	zhē dǎng	ocluir
折	zhé	dobra
折磨	zhé mó	torturado
侦探	zhēn tàn	detetive
斟酌	zhēn zhuó	considerar
珍贵	zhēn guì	precioso
珍稀	zhēn xī	raro
珍珠	zhēn zhū	pérola
真理	zhēn lǐ	verdade
真相	zhēn xiàng	a verdade
真挚	zhēn zhì	sincero
枕头	zhěn tou	travesseiro
振奋	zhèn fèn	elevar
振兴	zhèn xīng	revitalizar
镇定	zhèn dìng	calma
镇静	zhèn jìng	calma
阵地	zhèn dì	posição
阵容	zhèn róng	alinhar
震撼	zhèn hàn	choque
震惊	zhèn jīng	choque
争端	zhēng duān	disputa
争夺	zhēng duó	contenção
争气	zhēng qì	ganhar
争先恐后	zhēng xiān kǒng hòu	scrambling
争议	zhēng yì	disputa
征服	zhēng fú	conquistar
征收	zhēng shōu	coleção
挣扎	zhēng zhá	luta
正月	zhēng yuè	primeiro mês
蒸发	zhēng fā	evaporação
整顿	zhěng dùn	retificar
政策	zhèng cè	política
政权	zhèng quán	regime
正当	zhèng dāng	justificado
正负	zhèng fù	positivo e negativo
正规	zhèng guī	regular
正经	zhèng jing	grave
正气	zhèng qì	justiça
正义	zhèng yì	justiça
正宗	zhèng zōng	autêntico
症状	zhèng zhuàng	sintoma
证实	zhèng shí	confirme
证书	zhèng shū	certificado
郑重	zhèng zhòng	solenemente
之际	zhī jì	na ocasião
支撑	zhī chēng	apoio, suporte
支出	zhī chū	despesa
支流	zhī liú	afluente
支配	zhī pèi	dominar
支援	zhī yuán	apoio, suporte
支柱	zhī zhù	pilar
枝	zhī	ramo
知觉	zhī jué	percepção
知足常乐	zhī zú cháng lè	contentamento
脂肪	zhī fáng	gordura
侄子	zhí zi	sobrinho
值班	zhí bān	em serviço
执行	zhí xíng	realizado
执着	zhí zhuó	persistência
殖民地	zhí mín dì	colônia
直播	zhí bō	transmissão ao vivo
直径	zhí jìng	diâmetro
职能	zhí néng	função
职位	zhí wèi	posição
职务	zhí wù	posição
指标	zhǐ biāo	índice
指定	zhǐ dìng	especificamos
指甲	zhǐ jia	unhas
指令	zhǐ lìng	instrução
指南针	zhǐ nán zhēn	bússola
指示	zhǐ shì	instruções
指望	zhǐ wàng	contar com
指责	zhǐ zé	acusar
制裁	zhì cái	sanções
制服	zhì fú	uniforme
制约	zhì yuē	restrição
制止	zhì zhǐ	pare
志气	zhì qì	ambição
智力	zhì lì	inteligência
智能	zhì néng	inteligente
智商	zhì shāng	qi
治安	zhì ān	lei e ordem
治理	zhì lǐ	governança
滞留	zhì liú	fique
致辞	zhì cí	endereço
致力	zhì lì	compromissado com
致使	zhì shǐ	causa
中断	zhōng duàn	interromper
中立	zhōng lì	neutro
中央	zhōng yāng	central
忠诚	zhōng chéng	fidelidade
忠实	zhōng shí	fiel
终点	zhōng diǎn	fim
终究	zhōng jiū	depois de tudo
终身	zhōng shēn	vitalício
终止	zhōng zhǐ	terminação
衷心	zhōng xīn	sincero
种子	zhǒng zi	semente
种族	zhǒng zú	raça
肿瘤	zhǒng liú	tumor
众所周知	zhòng suǒ zhōu zhī	bem conhecido
种植	zhòng zhí	plantio
重心	zhòng xīn	centro de gravidade
周边	zhōu biān	em torno da
周密	zhōu mì	cuidado
周年	zhōu nián	aniversário
周期	zhōu qī	ciclo
周折	zhōu zhé	inversão de marcha
周转	zhōu zhuǎn	volume de negócios
州	zhōu	estado
粥	zhōu	mingau
舟	zhōu	barco
昼夜	zhòu yè	dia e noite
皱纹	zhòu wén	ruga
株	zhū	tensão
诸位	zhū wèi	todos
逐年	zhú nián	ano após ano
主办	zhǔ bàn	hospedeiro
主导	zhǔ dǎo	conduzindo
主管	zhǔ guǎn	supervisor
主流	zhǔ liú	convencional
主权	zhǔ quán	soberania
主义	zhǔ yì	doutrina
嘱咐	zhǔ fù	exortar
拄	zhǔ	aperto
住宅	zhù zhái	residencial
助理	zhù lǐ	assistente administrativo
助手	zhù shǒu	assistente
注射	zhù shè	injeção
注视	zhù shì	olhe para
注释	zhù shì	comente
注重	zhù zhòng	prestar atenção em
著作	zhù zuò	livro
铸造	zhù zào	casting
驻扎	zhù zhā	estacionado
拽	zhuài	arrastar
专长	zhuān cháng	perícia
专程	zhuān chéng	viagem especial
专利	zhuān lì	patente
专题	zhuān tí	tema
砖	zhuān	tijolo
转达	zhuǎn dá	transmitir
转让	zhuǎn ràng	transferir
转移	zhuǎn yí	transferir
转折	zhuǎn zhé	ponto de inflexão
传记	zhuàn jì	biografia
庄稼	zhuāng jià	cultivo
庄严	zhuāng yán	solene
庄重	zhuāng zhòng	solene
装备	zhuāng bèi	equipamento
装卸	zhuāng xiè	carregando e descarregando
壮观	zhuàng guān	espetacular
壮丽	zhuàng lì	magnífico
壮烈	zhuàng liè	heróico
幢	zhuàng	construção
追悼	zhuī dào	memorial
追究	zhuī jiū	investigar
坠	zhuì	cair
准则	zhǔn zé	diretrizes
卓越	zhuó yuè	excelência
琢磨	zhuó mó	ponderar
着手	zhuó shǒu	definir sobre
着想	zhuó xiǎng	por causa de
着重	zhuó zhòng	focar em
姿态	zī tài	atitude
滋润	zī rùn	hidratar
滋味	zī wèi	gosto
资本	zī běn	capital
资产	zī chǎn	ativos
资深	zī shēn	senior
资助	zī zhù	financiamento
子弹	zǐ dàn	bala
自卑	zì bēi	inferioridade
自发	zì fā	espontâneo
自力更生	zì lì gēng shēng	autossuficiência
自满	zì mǎn	complacente
自主	zì zhǔ	autônomo
宗教	zōng jiào	religião
宗旨	zōng zhǐ	objetivo
棕色	zōng sè	castanho
踪迹	zōng jì	vestígio
总而言之	zǒng ér yán zhī	contudo
总和	zǒng hé	soma
纵横	zòng héng	vertical e horizontal
走廊	zǒu láng	corredor
走漏	zǒu lòu	vazamento
走私	zǒu sī	contrabando
揍	zòu	batida
租赁	zū lìn	de concessão
足以	zú yǐ	suficiente
祖父	zǔ fù	avô
祖国	zǔ guó	pátria mãe
祖先	zǔ xiān	antepassado
阻碍	zǔ ài	dificultar
阻拦	zǔ lán	pare
阻挠	zǔ náo	obstruir
钻研	zuān yán	aprofundar
钻石	zuàn shí	diamante
嘴唇	zuǐ chún	lábios
罪犯	zuì fàn	criminoso
尊严	zūn yán	dignidade
遵循	zūn xún	segue
作弊	zuò bì	enganação
作废	zuò fèi	vazio
作风	zuò fēng	estilo
作息	zuò xī	descansar
做主	zuò zhǔ	dar ordens
座右铭	zuò yòu míng	lema
